Show Title,Theatre,Gross,Avg. Tix,SeatsSold,Prev.,RegularShows,TotalPerf.
'NIGHT MOTHER,ROYALE,2011480,52,38478,26,65,91
110 IN THE SHADE,STUDIO 54,5169314,51,102030,27,94,121
13,JACOBS,4436369,59,72907,22,105,127
1776,GERSHWIN,13667789,40,355683,34,333,367
1984,HUDSON,6859821,61,112232,38,125,163
33 VARIATIONS,EUGENE O'NEILL,4380302,63,70012,31,85,116
42ND STREET,FORD CENTER,133018977,59,2228839,31,1524,1555
42ND STREET - ORIGINAL,ST. JAMES,61642043,0,2116510,0,1920,1920
45 SECONDS FROM BROADWAY,RICHARD RODGERS,3839871,40,95966,31,73,104
700 SUNDAYS,BROADHURST,32029177,110,287428,28,209,237
9 TO 5,MARQUIS,15231411,70,218823,23,148,171
A BEHANDING IN SPOKANE,SCHOENFELD,7304015,72,102171,20,108,128
A BRONX TALE,WALTER KERR,4888172,66,74433,18,111,129
A BRONX TALE THE MUSICAL,LONGACRE,68722973,100,682876,28,700,728
A CATERED AFFAIR,WALTER KERR,6453273,67,95542,25,116,141
A CHANGE IN THE HEIR,EDISON,85757,0,8045,16,23,39
A CHORUS LINE,SCHOENFELD,54540021,79,681614,18,759,777
A Chorus Line - Original,SHUBERT,63997588,0,2170823,0,2456,2456
A CHRISTMAS CAROL,MARQUIS,8605616,62,118494,16,105,121
A CHRISTMAS STORY,LUNT-FONTANNE,8633547,94,89233,15,51,66
A CLASS ACT,AMBASSADOR,2558362,38,68094,30,105,135
A DAY IN THE DEATH OF JOE EGG,AMERICAN AIRLINES,2874477,45,63350,24,69,93
A DELICATE BALANCE,PLYMOUTH,18418588,69,289168,63,293,356
A DOLL'S HOUSE,BELASCO,6495976,45,143989,8,150,158
"A DOLL'S HOUSE, PART 2",GOLDEN,8304641,62,127990,30,172,202
A FEW GOOD MEN,MUSIC BOX,7729208,0,327659,15,497,512
A FREE MAN OF COLOR,VIVIAN BEAUMONT,2827517,50,57542,29,61,90
A FUNNY THING HAPPENED ON THE WAY TO THE FORUM,ST. JAMES,48856284,52,924216,35,715,750
A GENTLEMAN'S GUIDE TO LOVE AND MURDER,WALTER KERR,73749132,97,749169,30,905,935
A GRAND NIGHT FOR SINGING,CRITERION,1079709,0,39389,41,52,93
A LIFE IN THE THEATRE,SCHOENFELD,2583745,58,45770,24,56,80
A LITTLE HOTEL ON THE SIDE,BELASCO,1178462,0,48809,15,41,56
A LITTLE LIKE MAGIC,LYCEUM,265000,0,21000,11,49,60
A LITTLE MORE MAGIC,BELASCO,160000,0,7896,3,19,22
A LITTLE NIGHT MUSIC,WALTER KERR,38606667,104,368614,20,425,445
A MAN FOR ALL SEASONS,AMERICAN AIRLINES,3612196,56,64431,29,73,102
A MIDSUMMER NIGHT'S DREAM,LUNT-FONTANNE,2731254,41,67830,13,65,78
A MOM'S LIFE,BELASCO,11623,26,444,0,3,3
A MONTH IN THE COUNTRY,CRITERION,1407371,0,38369,24,55,79
A MONTH OF SUNDAYS,RITZ,132421,0,7862,19,4,23
A MOON FOR THE MISBEGOTTEN,BROOKS ATKINSON,5912588,76,78866,13,71,84
A MOON FOR THE MISBEGOTTEN 2000,WALTER KERR,5354179,52,102568,15,120,135
A NAKED GIRL ON THE APPIAN WAY,AMERICAN AIRLINES,3082541,53,57992,27,69,96
A NIGHT WITH JANIS JOPLIN,LYCEUM,7234546,80,90089,22,140,162
A RAISIN IN THE SUN,ROYALE,24194589,103,233479,59,173,232
A SMALL FAMILY BUSINESS,MUSIC BOX,1026887,0,46842,30,48,78
A SOLDIER'S PLAY,AMERICAN AIRLINES,4106326,74,55174,26,55,81
A STEADY RAIN,SCHOENFELD,15168742,139,109175,21,80,101
A STRANGE LOOP,LYCEUM,7517688,99,73752,13,78,91
A STREETCAR NAMED DESIRE,STUDIO 54,10139512,58,175558,56,178,234
A STREETCAR NAMED DESIRE - 1988,CIRCLE,761585,0,47247,21,84,105
A STREETCAR NAMED DESIRE - 1992,ETHEL BARRYMORE,5947347,0,146568,31,137,168
A STREETCAR NAMED DESIRE - 88,CIRCLE,761585,0,47247,21,84,105
A STREETCAR NAMED DESIRE - 92,ETHEL BARRYMORE,5947347,0,146568,31,137,168
A TALE OF TWO CITIES,AL HIRSCHFELD,4655502,60,77436,33,60,93
A THOUSAND CLOWNS,LONGACRE,2658624,46,56664,7,83,90
A THOUSAND CLOWNS 1996,CRITERION,1019814,29,34601,38,32,70
A TIME TO KILL,GOLDEN,1720560,56,32130,23,33,56
A TOUCH OF THE POET,STUDIO 54,3609646,52,69042,32,58,90
A TUNA CHRISTMAS,BOOTH,465078,0,13489,8,20,28
A VIEW FROM THE BRIDGE,CORT,19363208,82,232328,54,196,250
A VIEW FROM THE BRIDGE 1997-1998,NEIL SIMON,6475447,35,188903,35,239,274
A WALK IN THE WOODS,BOOTH,1562493,0,72519,21,137,158
A YEAR WITH FROG AND TOAD,CORT,1736421,43,40267,15,73,88
ABE LINCOLN IN ILLINOIS,VIVIAN BEAUMONT,1334845,0,56646,27,40,67
ABSURD PERSON SINGULAR,BILTMORE,1816196,49,37235,29,56,85
ACCENT ON YOUTH,FRIEDMAN,2028775,49,41751,24,71,95
ACCIDENTAL DEATH ANAR.,BELASCO,312887,0,22763,15,20,35
ACCOMPLICE,RICHARD RODGERS,935345,0,66323,23,52,75
ACT ONE,VIVIAN BEAUMONT,4761068,65,72546,31,67,98
AFTER MIDNIGHT,BROOKS ATKINSON,21234352,87,244603,18,273,291
AFTER MISS JULIE,AMERICAN AIRLINES,2534646,46,54538,40,53,93
AFTER THE FALL,AMERICAN AIRLINES,2998486,52,57353,40,53,93
AFTER THE NIGHT AND THE MUSIC,BILTMORE,1558313,47,33008,39,38,77
AH WILDERNESS,VIVIAN BEAUMONT,1721052,26,66008,30,54,84
AH WILDERNESS! - LONG DAY'S JOURNEY INTO NIGHT,NEIL SIMON,803598,0,31422,8,40,48
AIDA,PALACE,165928398,61,2714193,30,1852,1882
AIN'T BROADWAY GRAND,LUNT-FONTANNE,865780,0,30807,27,25,52
AIN'T MISBEHAVIN',AMBASSADOR,5332871,0,159433,8,176,184
AIN'T TOO PROUD,IMPERIAL,84225732,124,663794,21,485,506
AIRLINE HIGHWAY,FRIEDMAN,1521105,42,36708,25,53,78
ALADDIN,NEW AMSTERDAM,501150855,106,4718603,21,2790,2811
ALL ABOUT ME,HENRY MILLER,1354494,52,26494,27,20,47
ALL MY SONS,SCHOENFELD,17251132,89,195889,51,181,232
ALL MY SONS 1987,Golden,207092,0,12376,5,31,36
ALL SHOOK UP,PALACE,14447491,49,298652,33,213,246
ALL THE WAY,NEIL SIMON,19492726,109,177511,27,129,156
ALLEGIANCE,LONGACRE,8614614,76,113152,37,111,148
ALONE TOGETHER,MUSIC BOX,1135019,0,55617,15,97,112
ALTON BROWN LIVE: EAT YOUR SCIENCE,ETHEL BARRYMORE,580738,103,5651,0,8,8
AMADEUS,MUSIC BOX,5242594,43,121632,10,173,183
AMAZING GRACE,NEDERLANDER,5540127,60,92670,24,116,140
AMÃ‰LIE,WALTER KERR,5307176,82,64833,27,56,83
AMERICAN BUFFALO,BELASCO,8604009,95,88070,47,101,148
AMERICAN IDIOT,ST. JAMES,39798052,77,510723,26,422,448
AMERICAN PSYCHO,SCHOENFELD,5627480,78,72358,27,54,81
AMERICAN SON,BOOTH,9811233,117,84436,33,97,130
AMERICAN UTOPIA,HUDSON,40649176,138,295895,41,240,281
AMOUR,MUSIC BOX,1338399,46,29103,31,17,48
AMY'S VIEW,ETHEL BARRYMORE,5911176,50,117926,12,103,115
AN ACT OF GOD,STUDIO 54,15649525,100,147895,34,174,208
AN ALMOST HOLY PICTURE,AMERICAN AIRLINES,2534937,45,56198,19,69,88
AN AMERICAN DAUGHTER,CORT,2712516,30,93476,27,89,116
AN AMERICAN IN PARIS,PALACE,85539240,96,882254,29,623,652
AN ENEMY OF THE PEOPLE,FRIEDMAN,1967382,47,41886,26,59,85
AN EVENING WITH JERRY HERMAN,BOOTH,365391,34,11345,13,28,41
AN EVENING WITH PATTI LUPONE AND MANDY PATINKIN,BARRYMORE,3740974,90,41613,6,57,63
AN IDEAL HUSBAND,ETHEL BARRYMORE,7755341,35,220920,7,307,314
AN INSPECTOR CALLS,ROYALE,14597764,0,347361,13,454,467
ANASTASIA,BROADHURST,93439880,105,881733,34,808,842
ANGELS IN AMERICA,WALTER KERR,40937028,20,658578,72,697,769
ANN,VIVIAN BEAUMONT,5251537,63,84060,19,132,151
ANNA CHRISTIE,CRITERION,1138978,0,37992,24,53,77
ANNA IN THE TROPICS,ROYALE,3115592,46,67446,15,113,128
ANNA KARENINA,CIRCLE,569861,0,31895,18,46,64
ANNIE,PALACE,59051957,86,677853,38,487,525
ANNIE - 1997,MARTIN BECK,12836836,51,253160,14,239,253
ANNIE GET YOUR GUN,MARQUIS,82148713,58,1415850,35,1045,1080
ANY GIVEN DAY,LONGACRE,420620,0,24691,16,32,48
ANYTHING GOES,STEPHEN SONDHEIM,47288859,91,515954,32,521,553
ANYTHING GOES 1987-1989,VIVIAN BEAUMONT,30293686,0,815629,44,784,828
ARCADIA,ETHEL BARRYMORE,4881785,63,78061,20,108,128
Arcadia 1995,VIVIAN BEAUMONT,5818602,0,174341,31,173,204
AREN'T WE ALL,BROOKS ATKINSON,3208200,0,98681,19,93,112
ARMS AND THE MAN,CIRCLE,1231248,0,65324,23,109,132
ARSENIC AND OLD LACE,46TH STREET,3860980,0,204249,7,221,228
ART,ROYALE,24287247,45,529168,20,600,620
ARTIST DESCENDING A STAIRCASE,HELEN HAYES,478626,0,16636,11,36,47
AS IS,LYCEUM,2384737,0,133617,6,286,292
AS LONG AS WE BOTH SHALL LAUGH,AMERICAN AIRLINES,330477,24,14257,9,15,24
ASINAMALI,LAWRENCE,132801,0,9007,11,28,39
ASPECTS OF LOVE,BROADHURST,16026804,0,369318,22,377,399
ASSASSINS,STUDIO 54,6024383,57,106080,26,101,127
AUGUST: OSAGE COUNTY,IMPERIAL,32835606,70,463842,18,648,666
AVENUE Q,Golden,121918918,70,1731068,22,2534,2556
AWAKE AND SING!,BELASCO,3384141,45,74205,27,80,107
AZNAVOUR,MARQUIS,1331285,54,24766,1,23,24
BABY,ETHEL BARRYMORE,453966,0,17214,0,32,32
BABY IT'S YOU!,BROADHURST,9111694,57,159952,33,148,181
BAND IN BERLIN,HELEN HAYES,383380,37,10438,19,17,36
BANDSTAND,JACOBS,13487288,83,162335,24,166,190
BARBARA COOK,AMBASSADOR,187402,0,8311,13,13,26
BARBARA COOK: MOSTLY SONDHEIM,VIVIAN BEAUMONT,1202305,43,28176,5,26,31
BARBARA COOK'S BROADWAY,VIVIAN BEAUMONT,438437,43,10298,5,7,12
BAREFOOT IN THE PARK,CORT,4501355,54,82769,26,109,135
BARRY MANILOW,LUNT-FONTANNE,3466049,161,21647,0,17,17
BARRYMORE,MUSIC BOX,6566575,38,174965,12,236,248
BE MORE CHILL,LYCEUM,14217792,93,151941,30,177,207
BEA ARTHUR ON BROADWAY,BOOTH,1715877,46,37143,23,65,88
BEAUTIFUL,STEPHEN SONDHEIM,270497162,117,2290224,60,2416,2476
BEAUTY AND THE BEAST,LUNT-FONTANNE,429158458,50,7609397,46,5461,5507
BEETLEJUICE,WINTER GARDEN,65329970,100,653265,27,461,488
BELLS ARE RINGING,PLYMOUTH,3527176,50,71017,36,68,104
BENEFACTORS,BROOKS ATKINSON,4572197,0,161517,12,217,229
BENGAL TIGER AT THE BAGDHAD ZOO,RICHARD RODGERS,7889821,82,97721,23,108,131
BERNHARDT/HAMLET,AMERICAN AIRLINES,3886235,71,54742,26,63,89
BETRAYAL,AMERICAN AIRLINES,32621468,98,305392,79,281,360
BIG,SHUBERT,9736877,42,229895,22,193,215
BIG DEAL,BROADWAY,2270309,0,65947,8,69,77
BIG FISH,NEIL SIMON,10858194,74,146730,34,98,132
BIG RIVER,AMERICAN AIRLINES,2802669,47,60161,28,67,95
BILL MAHER: VICTORY BEGINS AT HOME,VIRGINIA,533861,43,12034,8,16,24
BILLY ELLIOT: THE MUSICAL,IMPERIAL,183514398,102,1787108,40,1312,1352
BILOXI BLUES,NEIL SIMON,13751235,0,519664,12,524,536
BIRTHDAY CANDLES,AMERICAN AIRLINES,3058687,66,46870,25,57,82
BLACK AND BLUE,MINSKOFF,33601122,0,934331,32,829,861
BLACK COMEDY/WHITE LIARS,CRITERION,650934,0,26256,25,38,63
BLACK TO THE FUTURE,MARQUIS,905893,98,9178,0,6,6
BLACKBIRD,BELASCO,7855675,74,107039,37,108,145
BLAST!,BROADWAY,8169127,40,203655,13,180,193
BLITHE SPIRIT,SHUBERT,11603724,71,162121,20,145,165
BLITHE SPIRIT 1987,NEIL SIMON,3248399,0,115210,24,104,128
BLOOD BROTHERS,MUSIC BOX,20752831,0,555459,13,840,853
BLOOD KNOT,Golden,845464,0,47366,13,95,108
BLOODY BLOODY ANDREW JACKSON,JACOBS,5629559,61,91636,26,94,120
BOBBI BOLAND,CORT,100389,39,2570,7,0,7
BOEING-BOEING,LONGACRE,13951563,61,227265,17,279,296
BOMBAY DREAMS,BROADWAY,22437579,61,366843,30,284,314
BONNIE AND CLYDE,SCHOENFELD,3277347,59,56138,33,36,69
BORN YESTERDAY,CORT,2792677,49,58288,28,73,101
BORN YESTERDAY 1989,46TH STREET,3093950,0,125354,13,153,166
BOYS CHOIR OF HARLEM AND FRIENDS,RICHARD RODGERS,182631,0,7327,4,14,18
BOYS IN AUTUMN,CIRCLE,440271,0,27040,21,70,91
BOYS OF WINTER,BILTMORE,237741,0,11420,31,9,40
BREAKFAST AT TIFFANY'S,CORT,2475937,66,37872,17,38,55
BREAKING THE CODE,NEIL SIMON,4186299,0,164051,9,169,178
BRIDGE AND TUNNEL,HELEN HAYES,6135555,60,102454,16,213,229
BRIEF ENCOUNTER,STUDIO 54,5210372,55,94033,21,111,132
BRIGHT STAR,CORT,7474494,67,111483,30,109,139
BRIGHTON BEACH MEMOIRS,NEDERLANDER,539369,26,21631,25,9,34
BRIGHTON BEACH MEMOIRS 1984-1986,46TH STREET,11823976,0,605927,0,808,808
BRING IN DA NOISE BRING IN DA FUNK,AMBASSADOR,54448939,48,1118863,15,1135,1150
BRING IT ON THE MUSICAL,ST. JAMES,11410177,63,180680,21,171,192
BROADWAY,ROYALE,43747,0,3071,3,4,7
BROADWAY BOUND,BROADHURST,15991551,0,612247,12,756,768
BROKEN GLASS,BOOTH,1393461,0,49960,15,73,88
BRONX BOMBERS,CIRCLE IN THE SQUARE,1212059,44,29511,31,29,60
BROOKLYN,SCHOENFELD,10108600,51,196826,27,284,311
BROOKLYN BOY,BILTMORE,2135668,49,43367,23,62,85
BUDDY,SHUBERT,7085959,0,206332,15,225,240
BULLETS OVER BROADWAY,ST. JAMES,18176367,80,226497,33,156,189
BURIED CHILD,BROOKS ATKINSON,1361820,23,59056,14,72,86
BURN THE FLOOR,LONGACRE,9285678,63,145582,8,185,193
BURN THIS,PLYMOUTH,19923583,28,420185,40,539,579
BUS STOP,CIRCLE,650106,21,31842,21,29,50
BUTLEY,BOOTH,5424237,73,74286,21,94,115
BUTTONS ON BROADWAY,AMBASSADOR,364581,0,16924,3,33,36
BY JEEVES,HELEN HAYES,2090954,59,35902,15,73,88
BYE BYE BIRDIE,HENRY MILLER,11485459,75,152597,40,117,157
CABARET,STUDIO 54,160539464,70,2267052,72,2765,2837
CABARET 1987-1988,MINSKOFF,10220724,0,292878,18,261,279
CAFE CROWN,BROOKS ATKINSON,392105,0,28930,0,42,42
CAMELOT,GERSHWIN,3714457,0,75937,4,56,60
CANCIONES DE MI PADRE,MINSKOFF,635122,0,16880,0,17,17
CANDIDA,CRITERION,762375,0,28448,24,45,69
CANDIDE,GERSHWIN,5065916,34,146016,10,104,114
CARETAKER,CIRCLE,385496,0,24335,23,45,68
"CAROLINE, OR CHANGE",STUDIO 54,5607244,76,73523,17,85,102
CAROUSEL,VIVIAN BEAUMONT,46906773,38,648453,85,518,603
CARRIE,VIRGINIA,341396,0,17752,16,5,21
CASA VALENTINA,FRIEDMAN,3028464,56,54116,24,79,103
CAT ON A HOT TIN ROOF,BROADHURST,24264540,86,282403,61,209,270
CAT ON A HOT TIN ROOF 2003-2004,MUSIC BOX,8898242,71,124967,28,145,173
CATCH ME IF YOU CAN,NEIL SIMON,16863570,70,242671,32,166,198
CATS,WINTER GARDEN,432003657,20,9333667,16,7385,7401
CATSKILLS ON BROADWAY,LUNT-FONTANNE,10354113,0,349212,19,453,472
CELEBRITY AUTOBIOGRAPHY,MARQUIS,223394,54,4124,0,3,3
CHAPLIN,BARRYMORE,8518390,72,118148,24,135,159
CHARLIE AND THE CHOCOLATE FACTORY,LUNT-FONTANNE,43679424,100,436089,27,305,332
CHECKMATES,46TH STREET,2396727,0,125264,16,172,188
CHESS,IMPERIAL,3806343,0,100726,17,68,85
CHICAGO,AMBASSADOR,705226635,73,9753843,25,10008,10033
CHICKEN & BISCUITS,CIRCLE IN THE SQUARE,1291806,45,31232,18,41,59
CHILDREN OF A LESSER GOD,STUDIO 54,3424264,55,62561,23,54,77
CHINA DOLL,SCHOENFELD,12630662,143,86727,40,54,94
CHINESE COFFEE/SALOME,CIRCLE,1395575,0,33793,29,30,59
CHINGLISH,LONGACRE,4325401,61,72385,19,109,128
CHITA RIVERA: THE DANCER'S LIFE,SCHOENFELD,3563420,62,57822,20,72,92
CHITTY CHITTY BANG BANG,HILTON THEATRE,27509505,64,426915,34,285,319
CHOIR BOY,FRIEDMAN,3854430,66,57759,31,72,103
CHRONICLE OF A DEATH FORETOLD,PLYMOUTH,1031381,0,48258,28,37,65
CHU CHEM,RITZ,381039,0,24176,0,68,68
CINDERELLA,BROADWAY,88166620,84,1039923,41,769,810
CIRQUE DREAMS: JUNGLE FANTASY,BROADWAY,5166140,56,92789,10,70,80
CITY OF ANGELS,VIRGINIA,45328992,0,1013486,24,879,903
CLOSER,MUSIC BOX,5318897,40,131326,17,172,189
CLYBOURNE PARK,WALTER KERR,8767402,66,133198,27,157,184
CLYDE'S,HAYES,2099849,60,34848,24,62,86
COASTAL DISTURBANCES,CIRCLE,2440201,0,141800,20,350,370
COLIN QUINN - AN IRISH WAKE,HELEN HAYES,241753,37,6542,2,22,24
COLIN QUINN: LONG STORY SHORT,HELEN HAYES,3075662,58,53090,21,135,156
COLLECTED STORIES,FRIEDMAN,1348639,42,32239,22,54,76
COME BACK LITTLE SHEBA,BILTMORE,2052427,54,37416,27,58,85
COME FLY AWAY,MARQUIS,18368158,85,218299,26,188,214
COME FROM AWAY,SCHOENFELD,197190799,122,1590596,25,1562,1587
COMEDY TONIGHT,LUNT-FONTANNE,134514,0,11981,5,9,14
COMPANY,BARRYMORE,38569057,91,408284,63,479,542
COMPANY - Original,CRITERION,2532590,4,55352,43,60,103
CONSTELLATIONS,FRIEDMAN,6642180,99,66543,29,76,105
CONTACT,VIVIAN BEAUMONT,60218526,64,931293,31,1010,1041
CONVERSATIONS WITH MY FATHER,ROYALE,10168415,0,334950,30,402,432
COPENHAGEN,ROYALE,11570839,44,263203,21,326,347
CORAM BOY,IMPERIAL,1602370,49,33065,17,30,47
CORPSE,HELEN HAYES,686380,0,14293,28,121,149
CRAZY FOR YOU,SHUBERT,92554871,1,2090822,26,1622,1648
CRAZY HE CALLS ME,WALTER KERR,143880,0,11084,16,7,23
CRISS ANGEL,LUNT-FONTANNE,434072,49,8794,0,7,7
CRY BABY,MARQUIS,4077104,34,120932,45,68,113
CUBA TEDDY BEAR,LONGACRE,1503086,0,57994,0,53,53
CURTAINS,AL HIRSCHFELD,43628368,75,582455,26,511,537
CYMBELINE,VIVIAN BEAUMONT,2080001,51,41739,34,40,74
CYRANO,NEIL SIMON,4135600,0,125574,38,137,175
CYRANO DE BERGERAC,RICHARD RODGERS,10467439,69,139229,53,108,161
DAME EDNA: BACK WITH A VENGEANCE,MUSIC BOX,7021853,63,110199,17,163,180
DAME EDNA: THE ROYAL TOUR,BOOTH,9815693,48,203582,39,297,336
DAMES AT SEA,HELEN HAYES,2540354,57,45367,32,85,117
DAMN YANKEES,MARQUIS,27913661,0,657446,18,534,552
DANA H.,LYCEUM,835529,48,16434,10,25,35
DANCE OF DEATH,BROADHURST,5426431,50,108898,27,108,135
DANCE OF THE VAMPIRES,MINSKOFF,9431254,61,156118,61,56,117
DANCING AT LUGHNASA,PLYMOUTH,10017136,0,314779,15,421,436
DANCING INTHE END ZONE,RITZ,113224,0,7958,15,28,43
DANGEROUS GAMES,NEDERLANDER,142550,0,9566,12,4,16
DANNY GANS ON BROADWAY,NEIL SIMON,84362,0,8271,11,6,17
DAVE CHAPPELLE,LUNT-FONTANNE,3069512,212,14913,0,10,10
DEAD ACCOUNTS,MUSIC BOX,3089827,79,39768,27,44,71
DEAR EVAN HANSEN,MUSIC BOX,260312301,166,1550970,21,1583,1604
DEATH AND THE MAIDEN,BROOKS ATKINSON,7232393,0,190203,33,159,192
DEATH OF A SALESMAN,BARRYMORE,12868982,116,110550,30,78,108
DEATH OF A SALESMAN 1984,BROADHURST,3681507,0,102821,0,88,88
DEATHANDKING'S HORSEMAN,VIVIAN BEAUMONT,474221,0,34521,19,33,52
DEF POETRY JAM,LONGACRE,3377597,33,99641,17,198,215
DEFENDING THE CAVEMAN,BOOTH,11720395,25,320334,25,674,699
DEMOCRACY,BROOKS ATKINSON,7091677,56,124982,17,173,190
DERREN BROWN: SECRET,CORT,7258069,82,88119,10,113,123
DESIGN FOR LIVING,AMERICAN AIRLINES,2984209,49,60606,30,69,99
DESIGN FOR LIVING 1985,CIRCLE,2142794,0,107881,17,245,262
DESIRE UNDER THE ELMS,ST. JAMES,1381950,52,26397,16,32,48
DEUCE,MUSIC BOX,5361739,60,86895,27,121,148
DIANA,LONGACRE,376471,69,5448,6,0,6
"DIANA, THE MUSICAL",LONGACRE,2467119,75,34370,16,34,50
DINNER AT EIGHT,VIVIAN BEAUMONT,2606844,42,61990,28,45,73
DIRTY BLONDE,HELEN HAYES,7925422,48,163977,20,352,372
DIRTY ROTTEN SCOUNDRELS,IMPERIAL,58033865,71,808025,36,627,663
DISASTER!,NEDERLANDER,4293431,61,70701,32,72,104
DISGRACED,LYCEUM,8534968,74,114762,27,149,176
DIVIDING THE ESTATE,BOOTH,2796827,54,51037,31,50,81
DOCTOR ZHIVAGO,BROADWAY,3197457,60,54370,26,23,49
DON'T DRESS FOR DINNER,AMERICAN AIRLINES,2130070,44,48420,32,61,93
DON'T GET GOD STARTED,LONGACRE,1865671,0,72528,18,85,103
DONNY AND MARIE: A BROADWAY CHRISTMAS,MARQUIS,2843463,112,24979,0,20,20
DOUBLES,RITZ,2342901,0,122866,10,277,287
DOUBT,WALTER KERR,27656473,67,406085,25,525,550
DR. SEUSS' HOW THE GRINCH STOLE CHRISTMAS!,HILTON THEATRE,22903349,68,322903,35,203,238
DRACULA THE MUSICAL,BELASCO,6109526,58,106028,22,157,179
DREAM: THE JOHNNY MERCER MUSICAL,ROYALE,3311853,39,84598,24,109,133
DREAMGIRLS,AMBASSADOR,4492189,0,154504,7,177,184
DREAMGIRLS 1984-1985,IMPERIAL,15471737,0,545965,0,496,496
DREAMS AND NIGHTMARES,MARTIN BECK,6033691,60,100217,21,55,76
DRIVING MISS DAISY,GOLDEN,13586627,102,131694,20,180,200
DROOD,IMPERIAL,20993477,0,665094,24,608,632
DROWNING CROW,BILTMORE,1619255,48,33799,23,54,77
EASTERN STANDARD,Golden,1197966,0,51347,20,92,112
ECLIPSED,GOLDEN,5744145,74,77911,14,121,135
ELAINE STRITCH AT LIBERTY,NEIL SIMON,5000248,59,84481,11,69,80
ELECTRA,ETHEL BARRYMORE,4629683,42,108893,15,116,131
ELF,AL HIRSCHFELD,17898004,104,168122,7,131,138
ELF-THE MUSICAL,AL HIRSCHFELD,594759,65,9190,8,0,8
ELLING,BARRYMORE,686837,35,20665,22,9,31
ENCHANTED APRIL,BELASCO,3492109,41,85013,24,143,167
END OF THE RAINBOW,BELASCO,6856068,69,99053,16,160,176
ENRON,BROADHURST,1489074,55,27431,22,16,38
EPIC PROPORTIONS,HELEN HAYES,1317751,36,36214,27,93,120
EQUUS,BROADHURST,11962267,86,140597,21,156,177
ESCAPE TO MARGARITAVILLE,MARQUIS,12444604,83,153544,29,124,153
EUGENE ONEGIN,MARTIN BECK,97542,0,4047,0,7,7
EVERYDAY RAPTURE,AMERICAN AIRLINES,2358299,45,53366,11,85,96
EVITA,MARQUIS,52678175,110,474853,26,337,363
EXECUTION OF JUSTICE,VIRGINIA,93247,0,7053,8,12,20
EXIT THE KING,BARRYMORE,6703380,69,96429,21,93,114
FACE VALUE,CORT,50114,0,2816,8,0,8
FAITH HEALER,BOOTH,7583448,76,99297,19,117,136
FALSETTOS,Golden,19931243,16,387283,53,570,623
FARINELLI AND THE KING,BELASCO,12193852,103,118919,14,111,125
FELA!,EUGENE O'NEILL,33452773,73,457401,38,491,529
FENCES,CORT,12908907,117,110215,13,88,101
FENCES 1987-1988,46TH STREET,13796739,0,533252,11,525,536
FESTEN,MUSIC BOX,1853946,53,35065,20,49,69
FIDDLER ON THE ROOF,MINSKOFF,107360337,69,1528524,70,1212,1282
FIDDLER ON THE ROOF 90-91,GERSHWIN,13629209,0,331803,18,241,259
FINDING NEVERLAND,LUNT-FONTANNE,64214541,88,723370,33,565,598
FINIAN'S RAINBOW,ST. JAMES,7888826,60,132659,22,92,114
FIRST DATE,LONGACRE,10018641,63,159061,34,174,208
FISH IN THE DARK,CORT,27652896,126,218241,33,173,206
FLAMENCO PURO,HELLINGER,1431495,0,47604,3,53,56
FLOWER DRUM SONG,VIRGINIA,11264444,64,173290,25,169,194
FLYING OVER SUNSET,VIVIAN BEAUMONT,2274957,57,40067,36,35,71
FOLLIES,MARQUIS,19566692,92,216360,38,152,190
FOLLIES 2001,BELASCO,7080718,55,128928,31,117,148
FOOL FOR LOVE,FRIEDMAN,3721858,71,52876,25,75,100
FOOL MOON,BROOKS ATKINSON,1686553,38,44657,7,49,56
FOOL MOON 1993,RICHARD RODGERS,5666265,0,202319,13,215,228
FOOL MOON 1995-1996,AMBASSADOR,2483746,19,69351,10,81,91
FOOTLOOSE,RICHARD RODGERS,37134917,47,780117,18,709,727
FOR COLORED GIRLS WHO HAVE CONSIDERED SUICIDE / WHEN THE RAINBOW IS ENUF,BOOTH,2067207,61,34577,23,51,74
FOREVER TANGO,SHUBERT,5518980,56,97257,13,187,200
Forever Tango 1997-1998,MARQUIS,13872413,40,350842,4,458,462
FORTUNE'S FOOL,MUSIC BOX,4318899,44,98735,28,127,155
FOSSE,BROADHURST,68997054,61,1121921,21,1093,1114
FOUR BABOONS ADORING,VIVIAN BEAUMONT,811304,0,45151,26,38,64
FRANKIE AND JOHNNY IN THE CLAIR DE LUNE,BROADHURST,3548264,64,57997,26,69,95
FRANKIE AND JOHNNY IN THE CLAIRE DE LUNE,BELASCO,11458493,56,195423,15,243,258
FRANKIE VALLI AND THE FOUR SEASONS ON BROADWAY,BROADWAY,2671259,128,21090,0,14,14
FREAK,CORT,5283095,34,158015,23,144,167
FREESTYLE LOVE SUPREME,BOOTH,17714172,114,152071,37,201,238
FROST/NIXON,JACOBS,9395227,65,141445,23,137,160
FROZEN,ST. JAMES,155193554,114,1359038,26,822,848
FROZEN 2004,CIRCLE,2252052,41,55085,6,128,134
FULLY COMMITTED,LYCEUM,7068657,76,93227,28,112,140
FUN HOME,CIRCLE IN THE SQUARE,41520587,98,416083,26,583,609
FUNNY GIRL,AUGUST WILSON,16927746,136,126117,30,81,111
GARDEN DISTRICT,CIRCLE,510674,0,23007,19,31,50
GARY: A SEQUEL TO TITUS ANDRONICUS,BOOTH,4503831,58,76853,45,65,110
GEM OF THE OCEAN,WALTER KERR,2577530,47,54245,15,72,87
GENTLEMEN PREFER BLONDES,LYCEUM,579727,0,19399,16,24,40
GEORGE GERSHWIN ALONE,HELEN HAYES,1055351,39,27495,16,96,112
GETTIN' THE BAND BACK TOGETHER,BELASCO,2045986,42,49295,30,40,70
GETTING AND SPENDING,HELEN HAYES,484281,35,14353,23,41,64
GETTING AWAY WITH MURDER,BROADHURST,1254380,33,37811,29,17,46
GETTING MARRIED,CIRCLE,794982,0,49295,22,70,92
GHETTO,CIRCLE,308308,0,18118,25,33,58
GHETTO KLOWN,LYCEUM,6179540,73,84440,25,95,120
GHOST,LUNT-FONTANNE,13339472,72,186851,39,136,175
GIGI,NEIL SIMON,7028015,73,96860,20,86,106
GIRL FROM THE NORTH COUNTRY,BELASCO,8750809,84,104425,31,172,203
GLENGARRY GLEN ROSS,JACOBS,22834337,97,231832,75,182,257
GLENGARRY GLEN ROSS 1984-1985,Golden,3558883,0,201282,0,296,296
GLORY DAYS,CIRCLE IN THE SQUARE,111283,39,3719,17,1,18
GOD OF CARNAGE,JACOBS,37345584,86,414191,24,452,476
"GOD SAID ""HA""",LYCEUM,286310,25,11388,11,22,33
GODSPELL,CIRCLE IN THE SQUARE,11106035,69,160892,30,264,294
GOLDA'S BALCONY,HELEN HAYES,9309657,50,180557,14,493,507
GOLDEN BOY,BELASCO,3106647,56,54318,30,53,83
GOLDEN CHILD,LONGACRE,828439,24,34346,11,69,80
GOOD PEOPLE,FRIEDMAN,5925428,73,81075,27,101,128
GORE VIDAL'S THE BEST MAN,VIRGINIA,24328421,81,298174,46,306,352
GRACE,CORT,6479055,76,85684,22,108,130
GRAND HORIZONS,HAYES,2259619,58,38572,35,45,80
GRAND HOTEL,GERSHWIN,43084265,0,1120499,31,1017,1048
GRAY'S ANATOMY,VIVIAN BEAUMONT,459423,0,25349,5,21,26
GREASE,BROOKS ATKINSON,47473854,86,551325,31,554,585
GREY GARDENS,WALTER KERR,17542980,75,234344,32,308,340
GRIND,HELLINGER,2369009,0,79934,25,71,96
GROUNDHOG DAY,AUGUST WILSON,19585335,90,217221,31,176,207
GUYS AND DOLLS,NEDERLANDER,10220561,67,152117,28,121,149
GUYS AND DOLLS 1992-1995,MARTIN BECK,65388544,0,1282292,33,1143,1176
GYPSY,ST. JAMES,31430300,71,441949,27,332,359
GYPSY 1989-1991,MARQUIS,29497916,0,765365,35,581,616
GYPSY 2003-2004,SHUBERT,37762532,68,549037,33,451,484
GYPSY PASSION,PLYMOUTH,614574,0,23042,0,55,55
HADESTOWN,WALTER KERR,104161279,154,671835,27,705,732
HAIR,AL HIRSCHFELD,54024621,77,682727,40,586,626
HAIRSPRAY,NEIL SIMON,252181270,73,3418653,31,2642,2673
HAMILTON,RICHARD RODGERS,743469418,246,3017717,26,2235,2261
HAMLET 1992,CRITERION,665378,0,28273,26,45,71
HAMLET 1995,BELASCO,5094936,0,105388,19,91,110
HAMLET 2009,BROADHURST,10010252,101,99759,25,72,97
HAND TO GOD,BOOTH,12134434,70,173143,26,311,337
HANDS ON A HARDBODY,BROOKS ATKINSON,1597428,40,41856,28,28,56
HANGMEN,GOLDEN,3385894,85,40720,21,68,89
HARRIGAN 'N HART,LONGACRE,288674,0,15114,25,4,29
HARRY CONNICK JR.,NEIL SIMON,2620770,127,20625,0,15,15
Harry Connick Jr. 1990,LUNT-FONTANNE,630158,0,19628,0,13,13
"HARRY CONNICK, JR. - A CELEBRATION OF COLE PORTER",NEDERLANDER,4434144,163,28568,5,21,26
HARRY POTTER AND THE CURSED CHILD,LYRIC,47185838,132,358999,24,226,250
"HARRY POTTER AND THE CURSED CHILD, PARTS ONE AND TWO",LYRIC,174056581,132,1324815,34,783,817
HARVEY,STUDIO 54,6802810,72,93579,32,62,94
HAVING OUR SAY,BOOTH,5342140,4,179225,24,317,341
HAY FEVER,MUSIC BOX,1622144,0,74796,16,124,140
HEAD OVER HEELS,HUDSON,7107981,61,121187,37,188,225
HEARTBREAK HOUSE,AMERICAN AIRLINES,3177764,47,67971,30,79,109
HEDDA GABLER 1994,CRITERION,868966,0,30070,37,33,70
HEDDA GABLER 2001-2002,AMBASSADOR,3297340,40,83031,17,117,134
HEDDA GABLER 2009,AMERICAN AIRLINES,2742238,49,56067,21,74,95
HEDWIG AND THE ANGRY INCH,BELASCO,50259435,107,459696,22,507,529
HEISENBERG,FRIEDMAN,4516447,78,57555,26,67,93
HELLO DOLLY!,LUNT-FONTANNE,6459815,26,144729,11,116,127
"HELLO, DOLLY!",SHUBERT,128198738,156,811203,34,550,584
HENRY IV,VIVIAN BEAUMONT,4870242,62,77060,20,58,78
HIGH,BOOTH,449955,26,18112,29,7,36
HIGH FIDELITY,IMPERIAL,1096116,55,20022,19,13,32
HIGH SOCIETY,ST. JAMES,7317557,43,168193,27,144,171
HILLARY AND CLINTON,GOLDEN,5240468,66,79786,37,77,114
HIZZONER,LONGACRE,137324,0,8752,12,12,24
HOLIDAY,CIRCLE,741050,17,30364,17,50,67
HOLIDAY INN,STUDIO 54,10143052,80,124170,38,117,155
HOLLER IF YA HEAR ME,PALACE,1209478,34,37161,17,38,55
HOLLYWOOD ARMS,CORT,2043835,44,47006,28,76,104
HOME FOR THE HOLIDAYS,AUGUST WILSON,481817,24,20609,6,47,53
HOME FRONT,ROYALE,156133,0,9180,11,13,24
HONEYMOON IN VEGAS,NEDERLANDER,7609536,66,117945,66,93,159
HONKY TONK NIGHTS,BILTMORE,78865,0,6122,14,4,18
HONOUR,BELASCO,1132819,28,41160,27,57,84
HOT FEET,HILTON THEATRE,3766746,49,76824,12,97,109
HOUSE OF BLUE LEAVES,PLYMOUTH,5700561,0,272340,0,352,352
HOW I LEARNED TO DRIVE,FRIEDMAN,3170132,72,43670,21,60,81
HOW TO SUCCEED IN BUSINESS WITHOUT REALLY TRYING,AL HIRSCHFELD,59740764,94,628957,30,473,503
HOW TO SUCCEED IN BUSINESS WITHOUT REALLY TRYING 95/96,RICHARD RODGERS,29473664,20,629821,16,548,564
HUGH JACKMAN - BACK ON BROADWAY,BROADHURST,14634985,156,93407,18,61,79
HUGHIE,CIRCLE,4697236,55,83562,46,93,139
HURLYBURLY,ETHEL BARRYMORE,6766948,0,250730,0,343,343
I AM MY OWN WIFE,LYCEUM,8648562,49,176011,26,360,386
I HATE HAMLET,WALTER KERR,1373609,0,73124,24,88,112
I'LL EAT YOU LAST: A CHAT WITH SUE MENGERS,BOOTH,9561477,137,69337,18,71,89
I'M NOT RAPPAPORT,BOOTH,793377,37,21365,15,53,68
I'm Not Rappaport 1985-1988,BOOTH,14858286,0,571321,0,891,891
I'M STILL HERE...DAMN IT!,BOOTH,1228086,38,32876,12,51,63
IAN MCKELLAN: KNIGHTOUT,LYCEUM,192571,0,3794,0,5,5
ICEMAN COMETH,LUNT-FONTANNE,1505587,0,58553,7,55,62
IF YOU EVER LEAVE MEâ€¦I'M GOING WITH YOU,CORT,1361049,37,36852,24,53,77
IF/THEN,RICHARD RODGERS,39635141,87,453766,29,401,430
IL DIVO - A MUSICAL AFFAIR,MARQUIS,1308223,142,9241,0,6,6
IMAGINARY FRIENDS,BARRYMORE,2857950,57,50516,20,76,96
IMPRESSIONISM,SCHOENFELD,2776558,64,44558,23,56,79
IN MY LIFE,MUSIC BOX,1557164,48,32307,23,61,84
IN THE HEIGHTS,RICHARD RODGERS,105302946,79,1322889,29,1184,1213
IN THE NEXT ROOM OR THE VIBRATOR PLAY,LYCEUM,2129999,45,47282,31,60,91
IN THE SUMMER HOUSE,VIVIAN BEAUMONT,713179,0,43370,28,25,53
IN TRANSIT,CIRCLE IN THE SQUARE,6075958,61,98204,36,145,181
INDECENT,CORT,6159154,57,104281,15,128,143
INDISCRETIONS,ETHEL BARRYMORE,6989870,0,182878,28,220,248
INHERIT THE WIND,LYCEUM,6411103,68,93909,19,100,119
INHERIT THE WIND 1996,ROYALE,2883421,44,65270,42,45,87
INK,FRIEDMAN,5289107,88,60205,24,87,111
INTO THE LIGHT,NEIL SIMON,91153,0,5969,13,6,19
INTO THE WOODS,BROADHURST,16112378,65,244727,25,279,304
INTO THE WOODS 1987-1989,MARTIN BECK,29851411,0,844043,43,765,808
IRENA'S VOW,WALTER KERR,3070112,48,64931,23,105,128
IRVING BERLIN'S WHITE CHRISTMAS,MARQUIS,759048,82,9224,0,7,7
IRVING BERLIN'S WHITE CHRISTMAS 2008-2009,MARQUIS,15467881,98,154130,25,97,122
IS HE DEAD?,LYCEUM,2882050,49,58357,13,105,118
IS THIS A ROOM,LYCEUM,1016193,50,18840,11,26,37
IT AIN'T NOTHIN' BUT THE BLUES,AMBASSADOR,6752894,40,170092,5,284,289
IT SHOULDA BEEN YOU,BROOKS ATKINSON,7881052,64,122504,31,135,166
IT'S A SLIPPERY SLOPE,VIVIAN BEAUMONT,410047,23,18091,2,17,19
IT'S ONLY A PLAY,SCHOENFELD,37500966,123,293622,48,274,322
IVANOV,VIVIAN BEAUMONT,2953109,36,83270,31,51,82
JACK: A NIGHT ON THE TOWN WITH JOHN BARRYMORE,BELASCO,73498,21,3513,4,12,16
JACKIE MASON: BRAND NEW,NEIL SIMON,4756677,0,256957,6,216,222
JACKIE MASON: FRESHLY SQUEEZED,HELEN HAYES,2964688,56,53002,14,172,186
JACKIE MASON: POLITICALLY INCORRECT,Golden,5061323,0,154724,13,348,361
JACKIE MASON: MUCH ADO ABOUT EVERYTHING,Golden,5303427,47,112483,33,186,219
JACKIE MASON'S LAUGHING ROOM ONLY,BROOKS ATKINSON,1015629,49,21844,31,14,45
JACKIE: AN AMERICAN LIFE,BELASCO,2261732,33,69868,34,128,162
JAGGED LITTLE PILL,BROADHURST,24322715,114,215062,36,168,204
JAKE'S WOMEN,NEIL SIMON,7675249,0,256752,14,245,259
JAMES JOYCE'S THE DEAD,BELASCO,4376057,48,91086,24,120,144
JANE EYRE,BROOKS ATKINSON,8083185,48,168879,36,209,245
JAY JOHNSON: THE TWO AND ONLY,HELEN HAYES,587011,48,12107,10,70,80
JEKYLL & HYDE,MARQUIS,2470240,65,39385,15,30,45
JEKYLL AND HYDE,PLYMOUTH,78056883,56,1403224,45,1543,1588
JELLY'S LAST JAM,VIRGINIA,31571770,0,666946,25,569,594
JEROME KERN HOLLYWOOD,RITZ,122449,0,8015,9,13,22
JEROME ROBBINS' BROADWAY,IMPERIAL,40683240,0,910410,55,633,688
JERRY SEINFELD,BROADHURST,774652,70,11060,0,10,10
JERRY'S GIRLS,ST. JAMES,3077118,0,122060,14,141,155
JERSEY BOYS,VIRGINIA,558416092,107,5150298,38,4642,4680
JERUSALEM,MUSIC BOX,8004618,67,118970,21,141,162
JESUS CHRIST SUPERSTAR,NEIL SIMON,10882991,78,141223,24,116,140
JESUS CHRIST SUPERSTAR 2000,FORD CENTER,11284435,45,250225,28,161,189
JITNEY,FRIEDMAN,3598741,68,52176,21,62,83
JOE EGG,LONGACRE,916650,0,50929,8,93,101
JOE TURNER'S COME AND GONE,BELASCO,3022226,45,66014,31,69,100
JOE TURNER'S COME AND GONE 1988,ETHEL BARRYMORE,1278722,0,64709,11,105,116
JOHN LITHGOW: STORIES BY HEART,AMERICAN AIRLINES,3971203,73,54139,21,61,82
JOSEPH AND THE AMAZING TECHNICOLOR DREAMCOAT,MINSKOFF,14280712,0,295962,17,231,248
JOURNEY'S END,BELASCO,2514849,48,53094,15,125,140
JUAN DARIEN,VIVIAN BEAUMONT,1187129,27,44121,20,49,69
JUDGMENT AT NUREMBERG,LONGACRE,2025590,35,57914,45,56,101
JULIUS CAESAR,BELASCO,8543103,83,102854,31,81,112
JUMPERS,BROOKS ATKINSON,3957158,50,78865,23,89,112
JUNK,VIVIAN BEAUMONT,6583820,77,85734,30,77,107
JUNO AND THE PAYCOCK,Golden,312358,0,11723,6,12,18
KAT AND THE KINGS,CORT,3418286,36,94995,15,157,172
KATHY GRIFFIN WANTS A TONY,BELASCO,1021880,106,9934,0,10,10
KIKI AND HERB: ALIVE ON BROADWAY,HELEN HAYES,619680,64,9520,5,27,32
KING CHARLES III,MUSIC BOX,9411612,96,98107,22,103,125
KING DAVID,NEW AMSTERDAM,677313,53,12745,3,6,9
KING HEDLEY II,VIRGINIA,2479599,36,68803,24,72,96
KING KONG,BROADWAY,36707905,79,464288,29,322,351
KING LEAR,VIVIAN BEAUMONT,9978653,72,136338,50,109,159
KINKY BOOTS,AL HIRSCHFELD,318990092,105,2980822,34,2505,2539
KIPLING,ROYALE,82583,0,4842,5,12,17
KISS ME KATE,MARTIN BECK,65051743,61,1056908,28,882,910
"KISS ME, KATE",STUDIO 54,14272788,95,149856,30,125,155
KISS OF THE SPIDER WOMAN,BROADHURST,42138889,0,863221,16,904,920
KRISTIN CHENOWETH: FOR THE GIRLS,NEDERLANDER,969894,101,9584,0,8,8
LA BETE,MUSIC BOX,4382858,61,73042,24,101,125
LA BOHÃˆME,BROADWAY,20773921,73,284906,12,228,240
LA CAGE AUX FOLLES - Original,PALACE,64214287,0,1948853,0,1440,1440
LA CAGE AUX FOLLES 1984-1987,PALACE,64214287,0,1948853,0,1440,1440
LA CAGE AUX FOLLES 2004-2005,MARQUIS,16381491,59,275385,34,226,260
LA CAGE AUX FOLLES 2010-2011,LONGACRE,29057813,83,347661,15,433,448
LACKAWANNA BLUES,FRIEDMAN,1033336,51,20060,18,27,45
LADY DAY AT EMERSON'S BAR & GRILL,CIRCLE IN THE SQUARE,14085440,113,124376,20,173,193
LARGELY NEW YORK,ST. JAMES,2300823,0,121825,11,144,155
LATE NITE COMIC,RITZ,97657,0,8456,15,4,19
LATIN HISTORY FOR MORONS,STUDIO 54,9504510,94,101009,20,104,124
LATINOLOGUES,HELEN HAYES,1104272,43,26013,34,93,127
LAUGH WHORE,CORT,1828501,46,39329,13,66,79
LAUGHTER ON THE 23RD FLOOR,RICHARD RODGERS,8326356,0,274611,24,320,344
LEADER OF THE PACK,AMBASSADOR,2739475,0,111515,53,120,173
LEAP OF FAITH,ST. JAMES,1343840,27,50021,25,19,44
LEGALLY BLONDE,PALACE,56338126,69,814072,30,595,625
LEGS DIAMOND,HELLINGER,5907024,0,138098,72,64,136
LEND ME A TENOR,ROYALE,16659783,18,478760,41,629,670
LENNON,BROADHURST,3596685,66,54449,42,49,91
LES LIAISONS DANGEREUSES,AMERICAN AIRLINES,9939835,79,127449,46,158,204
LES LIAISONS DANGEREUSES 1987,MUSIC BOX,3910600,0,137581,8,149,157
LES MISÃ‰RABLES,BROADHURST,143676240,85,1675778,39,1487,1526
LES MISÃ‰RABLES - ORIGINAL,IMPERIAL,406258901,23,8925169,11,6680,6691
LESTAT,PALACE,4630419,59,80434,32,40,72
LET IT BE,ST. JAMES,2535797,54,48350,10,46,56
LETTICE AND LOVAGE,ETHEL BARRYMORE,10945657,0,313850,15,286,301
LIFE x 3,CIRCLE,4570880,58,79272,21,104,125
LILLIAN,ETHEL BARRYMORE,279551,0,14224,5,45,50
LINDA VISTA,HAYES,1605102,56,29034,25,37,62
LITTLE ME,CRITERION,3266231,51,64069,43,99,142
LITTLE SHOP OF HORRORS,VIRGINIA,20607589,59,350389,40,372,412
LITTLE WOMEN,VIRGINIA,9793281,64,153439,55,137,192
LIVING ON LOVE,LONGACRE,811148,30,27322,21,16,37
LIZA'S AT THE PALACE,PALACE,3059851,101,31431,0,22,22
LOBBY HERO,HAYES,4795126,100,47672,30,56,86
LOMBARDI,CIRCLE IN THE SQUARE,9313391,63,147379,31,244,275
LONDON ASSURANCE,CRITERION,1493967,37,39976,14,72,86
LONG DAY'S JOURNEY,BROADHURST,1139393,0,43159,6,54,60
LONG DAY'S JOURNEY INTO NIGHT,PLYMOUTH,16487095,86,190648,33,178,211
LOOPED,LYCEUM,1262525,41,31207,27,33,60
LOOT,MUSIC BOX,1075400,0,52590,5,96,101
LORD OF THE DANCE: DANGEROUS GAMES,LYRIC,3616869,61,58276,4,67,71
LOSING LOUIE,BILTMORE,1548011,50,30824,24,53,77
LOST IN YONKERS,RICHARD RODGERS,23275602,0,772566,11,780,791
LOVE / LIFE,VIVIAN BEAUMONT,280480,41,6914,0,8,8
LOVE LETTERS,EDISON,4762317,36,85227,6,191,197
LOVE THY NEIGHBOR,BOOTH,3856374,36,106652,5,234,239
LOVE! VALOUR! COMPASSION!,WALTER KERR,5849633,0,179722,28,248,276
LOVEMUSIK,BILTMORE,2494723,60,41203,24,60,84
LOVES OF ANATOL,CIRCLE,405843,0,23388,15,46,61
LUCIFER'S CHILD,MUSIC BOX,259185,0,11635,6,28,34
LUCKY GUY,BROADHURST,22992145,141,163710,33,104,137
LYSISTRATA JONES,WALTER KERR,1391172,36,39217,34,30,64
M. BUTTERFLY,CORT,5248147,88,60311,19,61,80
MA RAINEY'S BLACK BOTTOM,ROYALE,2427214,52,45737,14,68,82
MA RAINEY'S BLACK BOTTOM 1984-1985,CORT,2619607,0,130019,9,276,285
MACBETH,BARRYMORE,22829932,99,219861,61,205,266
MACBETH 1988,HELLINGER,2799049,0,90957,8,77,85
MACBETH 2000,MUSIC BOX,489308,45,10926,8,13,21
MACBETH 2008,LYCEUM,4105572,80,51048,11,52,63
MACHINAL,AMERICAN AIRLINES,2123256,51,40813,28,52,80
MAGIC/BIRD,LONGACRE,1136102,33,34446,24,37,61
MAIL,MUSIC BOX,383246,0,21340,19,37,56
MAJOR BARBARA,AMERICAN AIRLINES,3217456,49,65138,32,74,106
MAMMA MIA!,CADILLAC WINTER G,624391693,82,7566124,14,5758,5772
MAN AND BOY,AMERICAN AIRLINES,3095607,57,53701,35,57,92
MAN OF LA MANCHA,AL HIRSCHFELD,22483426,66,343317,16,304,320
MAN OF LA MANCHA 1992,MARQUIS,8018715,0,167938,28,108,136
MANDY PATINKIN,LYCEUM,563627,46,12229,0,16,16
MANDY PATINKIN IN CONCERT: MAMALOSHEN,BELASCO,726465,42,17344,0,28,28
MANDY PATINKIN: DRESS CASUAL,HELEN HAYES,747986,0,24735,0,62,62
MANILOW ON BROADWAY,ST. JAMES,4160716,121,35432,2,25,27
MARC SALEM'S MIND GAMES,LYCEUM,287897,43,6866,1,30,31
MARIE CHRISTINE,VIVIAN BEAUMONT,2982095,43,69819,39,42,81
MARK TWAIN TONIGHT,BROOKS ATKINSON,617468,52,12184,3,15,18
MARLENE,CORT,681313,32,21342,15,25,40
MARRIAGE OF FIGARO,CIRCLE,664010,0,40852,22,77,99
MARTIN SHORT: FAME BECOMES ME,JACOBS,10842526,75,143480,22,165,187
MARVIN'S ROOM,AMERICAN AIRLINES,2366005,50,47375,23,68,91
MARY POPPINS,NEW AMSTERDAM,294558648,75,3877521,30,2619,2649
MARY STUART,BROADHURST,6088106,59,103007,22,137,159
MASTER CLASS,FRIEDMAN,3244777,61,52956,26,67,93
Master Class 1995,Golden,15082029,33,424668,12,598,610
MASTER HAROLDâ€¦AND THE BOYS,ROYALE,2276295,41,55872,31,49,80
MASTERGATE,CRITERION,691392,0,26715,23,69,92
MATCH,PLYMOUTH,2333156,47,49757,28,53,81
MATILDA,SHUBERT,198165852,94,2087293,37,1554,1591
MATTERS OF THE HEART,VIVIAN BEAUMONT,628230,36,17160,8,11,19
MAURITIUS,BILTMORE,2293948,56,41237,24,61,85
ME AND MY GIRL,MARQUIS,79655591,0,2061437,11,1417,1428
MEAN GIRLS,AUGUST WILSON,124199593,126,980469,29,801,830
MEDEA,BROOKS ATKINSON,2454181,41,58891,6,78,84
MEDEA 1994,LONGACRE,3435444,0,84470,9,83,92
MEET ME IN ST. LOUIS,GERSHWIN,9737393,0,289739,17,252,269
MEL BROOKS,LUNT-FONTANNE,583140,197,2967,0,2,2
MEMPHIS,SHUBERT,104453830,75,1380731,30,1165,1195
MEN ARE FROM MARS WOMEN ARE FROM VENUS,GERSHWIN,358316,32,11336,0,7,7
METAMORPHOSES,CIRCLE,10455094,52,199094,13,400,413
METAMORPHOSIS,ETHEL BARRYMORE,2684265,0,81045,5,96,101
METEOR SHOWER,BOOTH,10904520,154,70925,31,61,92
METRO,MINSKOFF,362026,0,20470,24,13,37
MICHAEL FEINSTEIN IN CONCERT,LYCEUM,1031433,0,31308,0,57,57
MICHAEL FEINSTEIN: ISN'T IT ROMANTIC,BOOTH,779339,0,23485,0,39,39
MICHAEL FEINSTEIN: PIANO AND VOICE,Golden,599078,0,19023,0,30,30
MIKE TYSON: UNDISPUTED TRUTH,LONGACRE,1204618,133,9160,2,10,12
MILLION DOLLAR QUARTET,NEDERLANDER,28585196,75,379726,34,489,523
MINNELLI ON MINNELLI,PALACE,2549836,89,29519,5,20,25
MISERY,BROADHURST,12518415,112,112692,27,102,129
MISS MARGARIDA'S WAY,HELEN HAYES,88048,0,11120,8,11,19
MISS SAIGON,BROADWAY,322103948,28,6584913,43,4432,4475
MIXED EMOTIONS,Golden,529998,0,30482,16,56,72
MJ THE MUSICAL,NEIL SIMON,34259286,125,269955,39,175,214
MOON FOR MISBEGOTTEN,CORT,62406,0,3928,0,7,7
MOON OVER BUFFALO,MARTIN BECK,11370536,25,317122,22,309,331
MORNING NOON AND NIGHT,VIVIAN BEAUMONT,504719,33,15504,7,12,19
MORNING'S AT SEVEN,LYCEUM,2766340,36,75829,27,112,139
MORRISSEY,LUNT-FONTANNE,1881374,187,10085,0,7,7
MORT SAHL ON BROADWAY,NEIL SIMON,192815,0,22329,5,26,31
MOSCOW CIRCUS,GERSHWIN,516462,0,17796,0,32,32
MOTHERS AND SONS,GOLDEN,3558406,60,60704,33,104,137
MOTOWN THE MUSICAL,LUNT-FONTANNE,116498633,107,1083376,37,762,799
MOULIN ROUGE!,AL HIRSCHFELD,72260393,195,371285,24,260,284
MOULIN ROUGE! THE MUSICAL,AL HIRSCHFELD,51501395,141,367915,0,299,299
MOVIN' OUT,RICHARD RODGERS,99473905,69,1429115,28,1295,1323
MR. SATURDAY NIGHT,NEDERLANDER,9551020,127,75846,28,55,83
MRS. DOUBTFIRE,STEPHEN SONDHEIM,10477682,99,105968,46,77,123
MRS. WARREN'S PROFESSION,AMERICAN AIRLINES,2917482,52,56201,35,65,100
MULE BONE,ETHEL BARRYMORE,907603,0,65135,28,68,96
MUMMENSCHANZ,HELEN HAYES,190000,0,22800,0,152,152
MY FAIR LADY,VIRGINIA,79772272,97,731887,55,674,729
MY FAVORITE YEAR,VIVIAN BEAUMONT,2005376,0,73023,45,36,81
MY LOVE LETTER TO BROADWAY,LUNT-FONTANNE,1854959,114,16313,0,12,12
MY NAME IS LUCY BARTON,FRIEDMAN,4289821,117,36179,10,47,57
MY ONE AND ONLY,ST. JAMES,12143496,0,388016,0,312,312
MY THING OF LOVE,MARTIN BECK,276763,0,18612,16,12,28
"NATASHA, PIERRE & THE GREAT COMET OF 1812",IMPERIAL,50069392,124,404558,32,336,368
NERD,HELEN HAYES,3624602,0,191117,15,441,456
NETWORK,BELASCO,31370836,145,215717,28,184,212
NEVER GONNA DANCE,BROADHURST,6287836,62,101949,44,84,128
NEWS,HELEN HAYES,115500,0,2875,22,4,26
NEWSIES,NEDERLANDER,109000717,94,1156757,16,1004,1020
NEXT FALL,HELEN HAYES,3056830,54,57552,26,132,158
NEXT TO NORMAL,BOOTH,31764486,66,473884,20,734,754
NICE WORK IF YOU CAN GET IT,IMPERIAL,51461746,94,543472,27,478,505
NICHOLAS NICKLEBY,BROADHURST,2136298,0,23933,3,29,32
NICK AND NORA,MARQUIS,3994646,0,108368,71,9,80
NIGHT MUST FALL,HELEN HAYES,2927757,37,81461,40,119,159
NO MAN'S LAND,CRITERION,1278139,0,39175,22,61,83
NO MAN'S LAND/WAITING FOR GODOT,CORT,14346510,89,160950,31,145,176
NOISES OFF,BROOKS ATKINSON,20017476,55,366417,51,415,466
NOISES OFF 1984-1985,BROOKS ATKINSON,6030479,0,252056,0,352,352
NOT ABOUT NIGHTINGALES,CIRCLE,2465086,42,59027,13,125,138
NOVEMBER,BARRYMORE,11194646,70,160076,38,200,238
OBA OBA,AMBASSADOR,632135,0,31313,18,46,64
OBA OBA '90,MARQUIS,1246379,0,57143,10,45,55
OBA OBA '93,MARQUIS,426432,0,26313,24,22,46
OCTETTE BRIDGE CLUB,MUSIC BOX,159337,0,12156,8,24,32
OF MICE AND MEN,LONGACRE,15938704,103,155377,31,118,149
OH CALCUTTA!,EDISON,11704235,0,826527,8,2580,2588
OH COWARD,HELEN HAYES,185000,0,16200,16,56,72
OH KAY!,LUNT-FONTANNE,2491192,0,89242,35,77,112
"OH, HELLO ON BROADWAY",LYCEUM,10160117,90,112188,18,120,138
OKLAHOMA!,CIRCLE IN THE SQUARE,22808138,107,212244,22,328,350
OKLAHOMA! 2002/2003,GERSHWIN,34961595,63,549805,25,388,413
OLD ACQUAINTANCE,AMERICAN AIRLINES,1809462,42,42829,31,61,92
OLD TIMES,AMERICAN AIRLINES,4039575,77,52787,21,64,85
OLDEST LIVING CONFEDERATE WIDOW TELLS ALL,LONGACRE,225202,38,6752,19,1,20
OLEANNA,GOLDEN,2177335,55,39824,15,65,80
ON A CLEAR DAY YOU CAN SEE FOREVER,ST. JAMES,7253179,83,88565,29,57,86
ON BORROWED TIME,CIRCLE,1303639,0,54810,21,101,122
ON GOLDEN POND,CORT,2947551,54,54757,19,93,112
ON THE TOWN,LYRIC,30840328,66,461901,28,368,396
ON THE TOWN 1988,GERSHWIN,5236292,37,143790,32,69,101
ON THE TWENTIETH CENTURY,AMERICAN AIRLINES,11298280,91,123479,33,144,177
ON THE WATERFRONT,BROOKS ATKINSON,375890,0,20691,16,8,24
ON YOUR FEET!,MARQUIS,83571600,94,879193,34,746,780
ONCE,JACOBS,110306780,100,1082027,23,1168,1191
ONCE ON THIS ISLAND,CIRCLE IN THE SQUARE,30783523,98,311099,29,457,486
ONCE ON THIS ISLAND Original Production,BOOTH,7109144,0,288391,19,469,488
ONCE UPON A MATTRESS,BROADHURST,7991729,45,174914,35,188,223
ONE FLEW OVER THE CUCKOO'S NEST,ROYALE,6477718,53,122341,24,121,145
"ONE MAN, TWO GUVNORS",MUSIC BOX,13071416,93,140382,13,159,172
ONE MO' TIME,LONGACRE,514302,39,13080,16,21,37
ORPHANS,SCHOENFELD,4056117,72,55985,27,37,64
ORPHEUS DESCENDING,NEIL SIMON,3598732,0,115625,13,97,110
OSLO,VIVIAN BEAUMONT,10875255,88,123509,23,109,132
OTHER DESERT CITIES,BOOTH,14799861,85,171304,25,261,286
OUR COUNTRY'S GOOD,NEDERLANDER,513073,0,44965,12,48,60
OUR MOTHER'S BRIEF AFFAIR,FRIEDMAN,1727741,49,35508,22,53,75
OUR TOWN,BOOTH,3757006,67,55571,15,59,74
OUR TOWN 1988-1989,LYCEUM,1625788,0,91557,27,136,163
OUTSIDE MULLINGAR,FRIEDMAN,3351777,66,50227,22,61,83
PACIFIC OVERTURES,STUDIO 54,3770036,53,71420,24,69,93
PACK OF LIES,ROYALE,1128508,0,59197,5,120,125
PAL JOEY,STUDIO 54,5574587,54,103821,37,85,122
PARADE,VIVIAN BEAUMONT,4349262,41,104752,39,85,124
PARADISE SQUARE,ETHEL BARRYMORE,4015755,53,76086,23,92,115
PARAMOUR,LYRIC,50071361,86,579261,31,366,397
PARK YOUR CAR IN HARVARD YARD,MUSIC BOX,1993298,0,89633,9,124,133
PASS OVER,AUGUST WILSON,1829204,42,45306,19,57,76
PASSING STRANGE,BELASCO,5161374,53,97370,20,165,185
PASSION,PLYMOUTH,10680035,0,238899,52,280,332
PATTI LABELLE ON BROADWAY,ST. JAMES,989597,56,17835,0,12,12
PATTI LUPONE ON BROADWAY,WALTER KERR,1640359,0,39633,8,45,53
PAUL ROBESON,LONGACRE,420109,13,14327,7,25,32
PENN & TELLER ON BROADWAY,MARQUIS,7418335,117,64567,7,41,48
PENN AND TELLER,RITZ,2531878,0,94586,8,122,130
PETER AND THE STARCATCHER,BROOKS ATKINSON,17698854,68,255200,18,319,337
PETER PAN,GERSHWIN,10218898,41,247843,0,174,174
PETER PAN 1990-1991,MARQUIS,7901151,19,171397,8,133,141
PHILADELPHIA: HERE I COME,CRITERION,1181442,0,37123,25,52,77
PICNIC,CRITERION,3349762,28,81257,62,94,156
PIPPIN,MUSIC BOX,68840074,103,659865,37,709,746
PLAY ON!,BROOKS ATKINSON,1402692,23,61278,19,61,80
PLAZA SUITE,HUDSON,27426493,209,131963,35,102,137
PORGY AND BESS,RICHARD RODGERS,26381453,90,293984,28,293,321
"POTUS: OR, BEHIND EVERY GREAT DUMBASS ARE SEVEN WOMEN TRYING TO KEEP HIM AL",SHUBERT,4922650,68,72840,13,78,91
PRECIOUS SONS,LONGACRE,573384,0,34808,28,60,88
PRELUDE TO A KISS,AMERICAN AIRLINES,1786550,43,41211,23,61,84
PRELUDE TO A KISS 1990-1991,HELEN HAYES,5819573,0,194011,8,440,448
PRESENT LAUGHTER,AMERICAN AIRLINES,15484083,74,196609,51,170,221
PRESENT LAUGHTER 1996-1997,WALTER KERR,4334972,33,133335,28,175,203
PRETTY WOMAN: THE MUSICAL,NEDERLANDER,51134569,113,449208,27,420,447
PRIMO,MUSIC BOX,1952699,65,29520,4,35,39
PRINCE OF BROADWAY,FRIEDMAN,4171311,77,54277,23,76,99
PRISCILLA QUEEN OF THE DESERT,PALACE,48763901,79,616609,23,526,549
PRIVATE LIVES,MUSIC BOX,445166,72,6204,0,9,9
PRIVATE LIVES 1992,BROADHURST,934802,0,30266,11,37,48
PRIVATE LIVES 2002,RICHARD RODGERS,7083941,54,132104,9,127,136
PRIVATE LIVES 2011,MUSIC BOX,2328466,64,36814,12,44,56
PROMISES PROMISES,BROADWAY,42951936,91,475458,30,289,319
PROOF,WALTER KERR,32896994,51,634994,16,917,933
PROPOSALS,BROADHURST,2172196,43,51007,10,77,87
PRUNE DANISH,ROYALE,2080448,59,35323,14,39,53
PRYMATE,LONGACRE,111855,33,3303,22,5,27
PUTTING IT TOGETHER,ETHEL BARRYMORE,5371370,57,94783,22,101,123
PYGMALION,AMERICAN AIRLINES,3558323,53,66932,31,69,100
PYGMALION 1987,PLYMOUTH,2492885,0,82271,15,113,128
QED,VIVIAN BEAUMONT,2165492,46,47492,8,40,48
QUILTERS,LAWRENCE,105736,0,6669,5,24,29
RABBIT HOLE,BILTMORE,3203305,55,58154,23,77,100
RACE,BARRYMORE,14939910,74,197595,23,297,320
RACING DEMON,VIVIAN BEAUMONT,1160216,16,43851,8,56,64
RADIO GOLF,CORT,1825735,39,46200,17,64,81
RAGGEDY ANN,NEDERLANDER,156625,0,10962,15,5,20
RAGS,HELLINGER,587081,0,24641,18,4,22
RAGTIME,NEIL SIMON,6030275,65,92587,28,65,93
RAGTIME 1997-2000,FORD CENTER,79947694,56,1432872,27,834,861
RAIN: A TRIBUTE TO THE BEATLES ON BROADWAY,NEIL SIMON,18014434,66,260709,8,300,308
REASONS TO BE PRETTY,LYCEUM,1936204,44,43457,21,85,106
RECKLESS,BILTMORE,3004690,50,59677,24,77,101
RED,GOLDEN,6835696,76,87631,22,101,123
REDWOOD CURTAIN,BROOKS ATKINSON,571015,0,34484,11,40,51
REGINA SPEKTOR,LUNT-FONTANNE,743114,102,7319,0,5,5
RELATIVELY SPEAKING,BROOKS ATKINSON,10077527,79,126852,35,117,152
RENT,NEDERLANDER,274248128,54,5026616,16,5123,5139
REQUIEM FOR A HEAVYWEIGHT,MARTIN BECK,114973,0,7355,8,3,11
RING OF FIRE,BARRYMORE,2775120,56,50623,38,57,95
RING ROUND THE MOON,BELASCO,1282880,27,47453,31,66,97
RINK,MARTIN BECK,1695147,0,61030,0,72,72
RIVERDANCE,GERSHWIN,45553810,51,890766,13,605,618
ROCK 'N' ROLL,JACOBS,6767495,66,102787,16,123,139
ROCK OF AGES,BROOKS ATKINSON,128993202,89,1476471,22,2328,2350
ROCKTOPIA,BROADWAY,4419436,65,67437,8,40,48
ROCKY,WINTER GARDEN,19222100,82,235400,28,180,208
ROMANCE ROMANCE,HELEN HAYES,3221064,0,123774,13,297,310
ROMEO AND JULIET,RICHARD RODGERS,6208798,75,84914,27,93,120
ROSE,LYCEUM,1230595,30,40598,13,42,55
ROWAN ATKINSON AT THE ATKINSON,BROOKS ATKINSON,53303,0,2899,7,7,14
ROYAL SHAKESPEARE COMPANY - CYRANO AND MUCH ADO,GERSHWIN,4668586,0,181064,9,112,121
ROZA,ROYALE,559330,0,20266,20,12,32
RUBEN & CLAY'S FIRST ANNUAL CHRISTMAS CAROL FAMILY FUN PAGEANT SPECTACULAR ,IMPERIAL,566548,36,15813,6,24,30
RUMORS,ETHEL BARRYMORE,12880034,0,447611,8,535,543
RUN FOR YOUR WIFE,VIRGINIA,460213,0,31540,13,47,60
RUNNING ON EMPTY,RICHARD RODGERS,997676,90,11120,0,8,8
SACRILEGE,BELASCO,357454,0,15394,8,21,29
SAFE SEX,LYCEUM,255062,0,12920,21,9,30
SAINT JOAN,LYCEUM,2897635,29,75082,39,103,142
SALLY MARR AND HER ESCORTS,HELEN HAYES,679156,0,21088,27,50,77
SALOME,BARRYMORE,3702428,66,56181,18,40,58
SARAFINA,CORT,13504133,0,548087,11,597,608
SATURDAY NIGHT FEVER,MINSKOFF,37585638,55,680429,27,501,528
SAY GOODNIGHT GRACIE,HELEN HAYES,5874615,45,131349,27,364,391
SCANDALOUS,NEIL SIMON,1718924,44,42216,31,29,60
SCHOOL FOR SCANDAL,LYCEUM,267650,16,9949,7,33,40
SCHOOL OF ROCK,WINTER GARDEN,160145109,95,1668057,31,1309,1340
SEA WALL/A LIFE,HUDSON,6509397,97,69022,14,60,74
SEARCH AND DESTROY,CIRCLE,419612,0,28882,22,46,68
SEARCH FOR SIGNS,PLYMOUTH,11404463,0,421543,14,391,405
SEASCAPE,BOOTH,1526743,41,38021,27,55,82
SEMINAR,GOLDEN,9819692,72,132687,25,191,216
SENATOR JOE,NEIL SIMON,5661,0,470,3,0,3
SERIOUS MONEY,ROYALE,413435,0,18856,21,15,36
SEUSSICAL,RICHARD RODGERS,12927734,56,228686,34,198,232
SEVEN GUITARS,WALTER KERR,4341182,34,130145,13,188,201
SEX AND LONGING,CORT,1474936,23,65593,30,46,76
Sexaholix 2001-2002,ROYALE,5337342,49,109522,53,67,120
Sexaholix 2003,BROADWAY,990923,49,20224,0,28,28
SHADOW BOX,CIRCLE,636598,0,27956,19,49,68
SHADOWLANDS,BROOKS ATKINSON,2712597,0,124173,11,169,180
SHAKESPEARE FOR MY FATHER,HELEN HAYES,2667045,0,97148,8,266,274
SHATNER'S WORLD: WE JUST LIVE IN IT,MUSIC BOX,914006,67,13721,2,17,19
SHE LOVES ME,BROOKS ATKINSON,22460756,24,422778,73,486,559
SHENANDOAH,VIRGINIA,798610,0,32251,15,32,47
SHERLOCK'S LAST CASE,NEDERLANDER,2122057,0,83806,12,124,136
SHIMADA,BROADHURST,218103,0,11950,20,4,24
SHINING CITY,BILTMORE,3217082,55,57529,21,80,101
SHIRLEY VALENTINE,BOOTH,3918566,0,170791,8,324,332
SHOGUN: THE MUSICAL,MARQUIS,2913428,0,88687,18,72,90
SHOW BOAT,GERSHWIN,89171712,25,1585144,12,947,959
SHREK THE MUSICAL,BROADWAY,46361426,76,606280,37,441,478
"SHUFFLE ALONG, OR, THE MAKING OF THE MUSICAL SENSATION OF 1921 AND ALL THAT",MUSIC BOX,15174445,116,131619,38,100,138
SID CEASAR AND COMPANY,Golden,48958,0,2455,6,5,11
SIDE MAN,Golden,9808327,35,276876,27,517,544
SIDE SHOW,RICHARD RODGERS,9278312,50,188033,52,147,199
SIGHT UNSEEN,BILTMORE,2724614,54,50622,21,70,91
SIGNIFICANT OTHER,BOOTH,1707469,50,35075,18,61,79
SINGIN' IN THE RAIN,GERSHWIN,13303713,0,441579,38,367,405
SISTER ACT,BROADWAY,52509237,73,721574,28,561,589
SIX,BROOKS ATKINSON,50161374,147,341191,45,296,341
SIX DANCE LESSONS IN SIX WEEKS,BELASCO,716751,32,22321,26,30,56
SIX DEGREES OF SEPARATION,VIVIAN BEAUMONT,18983263,10,503721,32,548,580
SIXTEEN WOUNDED,WALTER KERR,509381,38,13482,28,12,40
SKELETON CREW,FRIEDMAN,1122880,38,28022,22,30,52
SKYLIGHT,ROYALE,14640395,78,191759,33,201,234
SLAVA'S SNOWSHOW,HELEN HAYES,5404274,82,66447,10,97,107
SLAVE PLAY,GOLDEN,10124246,68,142476,38,178,216
SLEIGHT OF HAND,CORT,309141,0,21844,31,9,40
SLY FOX,BARRYMORE,8121077,57,141591,22,173,195
SMILE,LUNT-FONTANNE,1605546,0,53631,11,48,59
SMOKEY JOE'S CAFE,VIRGINIA,88346877,40,1904856,25,2036,2061
SO LONG LONELY STREET,LAWRENCE,119659,0,11313,8,53,61
SOCIAL SECURITY,ETHEL BARRYMORE,7412113,0,282222,26,388,414
SOLITARY CONFINEMENT,NEDERLANDER,394967,0,29074,15,25,40
SOME AMERICANS ABROAD,VIVIAN BEAUMONT,480112,0,27761,6,55,61
SOMEONE WHO'LL WATCH OVER ME,BOOTH,3943981,0,133087,5,232,237
SOMETHING ROTTEN!,ST. JAMES,73500381,84,870214,32,708,740
SONDHEIM ON SONDHEIM,STUDIO 54,5352642,60,89781,37,76,113
SONG AND DANCE,ROYALE,13004714,0,395212,17,474,491
SOUL DOCTOR,CIRCLE IN THE SQUARE,1940459,39,51690,32,66,98
SOUL OF SHAOLIN,MARQUIS,1225360,41,30406,3,21,24
SOUTH PACIFIC,VIVIAN BEAUMONT,96518652,99,965647,37,996,1033
SOUVENIR,LYCEUM,945935,43,21953,14,68,82
SPAMALOT,SHUBERT,168067350,80,2075781,34,1575,1609
SPEED THE PLOW,BARRYMORE,8477093,73,114722,24,140,164
SPEED-THE-PLOW,ROYALE,5543129,0,236777,23,279,302
SPIDER-MAN TURN OFF THE DARK,FOXWOODS,212406040,101,2067661,182,1066,1248
SPOILS OF WAR,MUSIC BOX,640059,0,30209,14,36,50
SPONGEBOB SQUAREPANTS,PALACE,37315330,76,485793,29,327,356
SPRING AWAKENING,EUGENE O'NEILL,66623990,74,886425,51,994,1045
SPRINGSTEEN ON BROADWAY,WALTER KERR,113058952,506,223585,7,229,236
SQUONK,HELEN HAYES,466157,35,13579,24,32,56
STAND-UP TRAGEDY,CRITERION,74326,0,4258,12,13,25
STANLEY,CIRCLE,1197565,24,48320,18,77,95
STARDUST,BILTMORE,776361,0,52993,16,101,117
STARLIGHT EXPRESS,GERSHWIN,42622032,0,1153702,22,761,783
STARMITES,CRITERION,520358,0,23948,35,60,95
STATE FAIR,MUSIC BOX,2926843,40,73138,8,110,118
STEEL MAGNOLIAS,LYCEUM,4139622,57,72860,23,136,159
STEEL PIER,RICHARD RODGERS,5587523,47,120530,33,76,109
STEPPING OUT,Golden,1006542,0,46054,21,73,94
STICK FLY,CORT,4262543,53,80312,24,93,117
STONES IN HIS POCKETS,Golden,5141100,44,115757,11,198,209
STRAIGHT WHITE MEN,HAYES,3629411,81,44978,27,56,83
STRANGE INTERLUDE,NEDERLANDER,1602954,0,44844,7,63,70
STREET CORNER SYMPHONY,BROOKS ATKINSON,1090010,17,64792,25,79,104
SUMMER,LUNT-FONTANNE,31490520,97,321684,27,288,315
SUMMER AND SMOKE,CRITERION,1194418,33,36681,22,53,75
SUNDAY IN THE PARK WITH GEORGE,STUDIO 54,19000206,84,225866,43,210,253
SUNDAY IN THE PARK WITH GEORGE 1984-1985,BOOTH,13820056,0,405866,0,568,568
SUNSET BOULEVARD,MINSKOFF,107159659,42,1689005,24,1115,1139
SUPERIOR DONUTS,MUSIC BOX,4239113,58,74490,17,109,126
SWAN LAKE,NEIL SIMON,7027858,50,141151,11,124,135
SWEAT,STUDIO 54,4881458,70,70653,24,105,129
SWEENEY TODD,EUGENE O'NEILL,20856882,74,282403,11,349,360
SWEENEY TODD 1989-1990,CIRCLE,2447741,0,103111,47,188,235
SWEET CHARITY,AL HIRSCHFELD,34027372,27,744524,40,648,688
SWEET CHARITY 86-87,MINSKOFF,15373615,0,444510,15,369,384
SWEET SMELL OF SUCCESS,MARTIN BECK,7860322,66,119972,18,109,127
SWEET SUE,ROYALE,2466416,0,103903,16,164,180
SWING!,ST. JAMES,24623691,47,529583,43,461,504
SWINGING ON A STAR,MUSIC BOX,1772083,16,51442,19,96,115
SYLVIA,CORT,4453376,60,75926,27,79,106
TABOO,PLYMOUTH,4894998,71,70160,16,100,116
TAKE ME ALONG,MARTIN BECK,71190,0,4320,7,1,8
TAKE ME OUT,WALTER KERR,17233072,64,272345,58,434,492
TAKING SIDES,BROOKS ATKINSON,1723675,26,67592,15,85,100
TAKING STEPS,CIRCLE,852636,0,51389,22,78,100
TALK RADIO,LONGACRE,4489013,53,84405,29,121,150
TALLER THAN A DWARF,LONGACRE,2557061,39,65891,37,56,93
TANGO ARGENTINO,GERSHWIN,8561544,11,249818,8,262,270
TANGO PASION,LONGACRE,138027,0,5873,6,5,11
TARTUFFE,AMERICAN AIRLINES,2638852,43,61354,40,53,93
TARTUFFE 1997,CIRCLE,321371,19,17029,25,29,54
TARZAN,RICHARD RODGERS,42722858,73,580903,35,486,521
TEDDY AND ALICE,MINSKOFF,2156947,0,65251,11,77,88
THAT CHAMPIONSHIP SEASON,JACOBS,8443019,85,99407,28,97,125
THE 25TH ANNUAL PUTNAM COUNTY SPELLING BEE,CIRCLE,45625516,67,672139,21,1136,1157
THE 39 STEPS,AMERICAN AIRLINES,22104342,57,389835,31,763,794
THE ADDAMS FAMILY,LUNT-FONTANNE,86677092,92,920997,35,722,757
THE ADVENTURES OF TOM SAWYER,MINSKOFF,2211829,34,64852,34,21,55
THE AMERICAN PLAN,FRIEDMAN,2001797,51,38583,22,70,92
THE ANARCHIST,GOLDEN,1651411,73,22583,23,17,40
THE APPLE DOESN'T FALL,LYCEUM,98544,19,5256,19,1,20
THE APPLE TREE,STUDIO 54,4777523,54,87752,18,99,117
THE ASSEMBLED PARTIES,FRIEDMAN,5402056,65,82288,28,119,147
THE AUDIENCE,SCHOENFELD,22072987,151,146613,22,114,136
THE BAND'S VISIT,ETHEL BARRYMORE,67910865,110,612394,36,588,624
THE BEAUTY QUEEN OF LEENANE,WALTER KERR,12496388,44,281378,19,365,384
THE BEST LITTLE WHOREHOUSE GOES PUBLIC,LUNT-FONTANNE,756503,0,40023,28,16,44
THE BIG KNIFE,AMERICAN AIRLINES,2337664,51,45618,29,56,85
THE BIG LOVE,PLYMOUTH,519527,0,25658,11,41,52
THE BLONDE IN THE THUNDERBIRD,BROOKS ATKINSON,191165,14,15122,10,9,19
THE BLUE ROOM,CORT,4589721,45,101355,15,81,96
THE BOOK OF MORMON,EUGENE O'NEILL,694132759,158,4375926,28,4021,4049
THE BOY FROM OZ,IMPERIAL,42738338,81,524857,32,364,396
THE BOYS FROM SYRACUSE,AMERICAN AIRLINES,3286075,48,68115,29,73,102
THE BOYS IN THE BAND,BOOTH,14943570,160,93222,35,84,119
THE BRIDGES OF MADISON COUNTY,SCHOENFELD,6729931,67,101215,37,100,137
THE CAINE MUTINY COURT-MARTIAL,SCHOENFELD,945803,49,19409,27,17,44
THE CAPEMAN,MARQUIS,8038402,53,152983,59,68,127
THE CARETAKER,AMERICAN AIRLINES,2156333,45,48149,19,63,82
THE CEMETERY CLUB,BROOKS ATKINSON,363036,0,36367,10,56,66
THE CHAIRS,Golden,1830517,38,48303,10,74,84
THE CHER SHOW,NEIL SIMON,39260781,105,375095,34,295,329
THE CHERRY ORCHARD,MARTIN BECK,4699478,69,68736,36,69,105
THE CHILDREN,FRIEDMAN,2390093,57,41588,15,63,78
THE CIRCLE,AMBASSADOR,4075985,0,150710,8,208,216
THE CIVIL WAR,ST. JAMES,3524775,43,81971,35,61,96
THE COAST OF UTOPIA,VIVIAN BEAUMONT,10085758,72,139695,25,120,145
THE COAST OF UTOPIA [PART 1 - VOYAGE],VIVIAN BEAUMONT,1676577,59,30838,31,1,32
THE COLOR PURPLE,BROADWAY,148718479,83,1818873,63,1360,1423
THE COLUMNIST,FRIEDMAN,3505086,59,59702,23,86,109
THE COMEDY OF ERRORS,VIVIAN BEAUMONT,980176,0,59348,23,65,88
THE CONSTANT WIFE,AMERICAN AIRLINES,3365506,53,63263,23,77,100
THE COUNTRY GIRL,JACOBS,5949235,74,81577,25,97,122
THE COUNTRY HOUSE,FRIEDMAN,2383928,54,44110,26,61,87
THE CRIPPLE OF INISHMAAN,CORT,7845617,83,94219,9,105,114
THE CRUCIBLE,VIRGINIA,19344830,79,246671,51,226,277
THE CRUCILE 1991-1992,BELASCO,1185344,0,50154,23,31,54
THE CURIOUS INCIDENT OF THE DOG IN THE NIGHT-TIME,ETHEL BARRYMORE,68321435,94,712343,23,799,822
THE DEEP BLUE SEA,CRITERION,1379259,36,38764,29,61,90
THE DEVIL'S DISCIPLE,CIRCLE,897856,0,55502,27,113,140
THE DIARY OF ANNE FRANK,MUSIC BOX,6086337,38,156663,15,221,236
THE DINNER PARTY,MUSIC BOX,13974313,48,291757,20,364,384
THE DROWSY CHAPERONE,MARQUIS,63565088,72,865975,32,674,706
THE ELEPHANT MAN,ROYALE,16291917,112,136696,58,140,198
THE ENCOUNTER,GOLDEN,4370573,65,67056,11,117,128
THE FARNSWORTH INVENTION,MUSIC BOX,4512535,59,76700,34,104,138
THE FATHER,CRITERION,4739487,51,90104,55,130,185
THE FERRYMAN,JACOBS,29427550,108,270524,20,296,316
THE FLOWERING PEACH,LYCEUM,354805,0,16725,14,41,55
THE FLYING KARAMAZOV BROTHERS,HELEN HAYES,658808,0,19501,7,50,57
THE FROGS,VIVIAN BEAUMONT,7691480,66,117040,34,92,126
THE FRONT PAGE,VIVIAN BEAUMONT,23135177,81,237246,60,174,234
THE GATHERING,CORT,360983,32,11208,12,24,36
THE GERSHWINS' FASCINATING RHYTHM,LONGACRE,970692,37,26455,27,17,44
THE GIN GAME,LYCEUM,7775151,50,152435,42,237,279
THE GLASS MENAGERIE,BARRYMORE,25419579,67,337554,103,435,538
THE GLASS MENAGERIE REVIVAL 94-95,CRITERION,1302177,0,37380,19,57,76
THE GOAT OR WHO IS SYLVIA?,Golden,7932478,44,179887,23,309,332
THE GOOD BODY,BOOTH,843035,43,19837,27,40,67
THE GOODBYE GIRL,MARQUIS,11456076,0,264638,23,188,211
THE GOSPEL AT COLONUS,LUNT-FONTANNE,1166390,0,50165,15,61,76
THE GOVERNMENT INSPECTOR,LYCEUM,476817,0,20677,16,37,53
THE GRADUATE,PLYMOUTH,17834908,54,321840,24,380,404
THE GRAPES OF WRATH,CORT,5031529,0,158138,11,188,199
THE GREAT SOCIETY,VIVIAN BEAUMONT,4755412,73,65268,26,72,98
THE GREEN BIRD,CORT,1787997,50,37182,15,56,71
THE HEIDI CHRONICLES,PLYMOUTH,16413783,7,543543,35,675,710
THE HEIGHT OF THE STORM,FRIEDMAN,3161762,75,42281,15,72,87
THE HEIRESS,CORT,19273881,29,423708,60,457,517
THE HIGH ROLLERS SOCIAL AND PLEASURE CLUB,HELEN HAYES,110732,0,7243,19,13,32
THE HISTORY BOYS,BROADHURST,16986043,77,219895,13,185,198
THE HOMECOMING,CORT,4267706,56,75092,15,137,152
THE HOMECOMING 1991,CRITERION,635768,0,29202,23,49,72
THE HOUSE OF BLUE LEAVES,WALTER KERR,5707721,76,74693,21,72,93
THE HUMANS,HELEN HAYES,24441207,92,266108,28,365,393
THE ICEMAN COMETH,BROOKS ATKINSON,21685048,105,211696,38,169,207
THE ILLUSIONISTS - LIVE ON BROADWAY,NEIL SIMON,6785761,102,64713,0,64,64
THE ILLUSIONISTS - MAGIC OF THE HOLIDAYS,MARQUIS,14973669,104,137931,0,116,116
THE ILLUSIONISTS - TURN OF THE CENTURY,PALACE,5847010,81,68843,0,57,57
THE ILLUSIONISTS - WITNESS THE IMPOSSIBLE,MARQUIS,8157068,105,76365,9,45,54
THE IMPORTANCE OF BEING EARNEST,AMERICAN AIRLINES,8012925,65,122818,30,189,219
THE INHERITANCE,ETHEL BARRYMORE,10904126,92,117559,45,130,175
THE INVENTION OF LOVE,LYCEUM,3918862,37,104598,31,108,139
THE JUDAS KISS,BROADHURST,4629082,46,99964,6,103,109
THE KENTUCKY CYCLE,ROYALE,863562,0,28251,15,33,48
THE KING AND I,NEIL SIMON,104348686,77,1397860,66,1279,1345
The King and I1984-1985,BROADWAY,12556649,0,328128,16,191,207
THE LAST NIGHT OF BALLYHOO,HELEN HAYES,11548547,47,243216,24,556,580
THE LAST SHIP,NEIL SIMON,11156287,84,131411,29,105,134
THE LEHMAN TRILOGY,NEDERLANDER,13467763,136,100012,18,82,100
THE LIEUTENANT OF INISHMORE,LYCEUM,3808107,50,76621,16,142,158
THE LIFE,ETHEL BARRYMORE,18961995,49,384256,21,466,487
THE LIFESPAN OF A FACT,STUDIO 54,14409286,125,115552,32,101,133
THE LIGHT IN THE PIAZZA,VIVIAN BEAUMONT,28777131,68,420433,36,504,540
THE LIGHTNING THIEF,LONGACRE,5061724,61,79999,30,95,125
THE LION IN WINTER,CRITERION,2099821,41,51829,22,93,115
THE LION KING,NEW AMSTERDAM,1750224774,108,16230673,33,9623,9656
THE LITTLE DOG LAUGHED,CORT,3345956,49,68122,22,112,134
THE LITTLE FOXES,VIVIAN BEAUMONT,7973018,63,134141,49,144,193
THE LITTLE MERMAID,LUNT-FONTANNE,82993600,83,986179,50,685,735
THE LITTLE PRINCE,BROADWAY,1888591,61,34889,14,32,46
THE LONESOME WEST,LYCEUM,619334,31,20296,9,55,64
THE LOOK OF LOVE,BROOKS ATKINSON,2344600,40,59883,35,49,84
THE LYONS,CORT,2509091,45,57421,21,80,101
THE MAN WHO CAME TO DINNER,AMERICAN AIRLINES,3854225,49,79268,32,85,117
THE MAN WHO HAD ALL THE LUCK,AMERICAN AIRLINES,2610518,45,57457,15,70,85
THE MASTER BUILDER,BELASCO,786602,0,35635,11,44,55
THE MERCHANT OF VENICE,BROADHURST,15335104,133,115374,20,79,99
THE MERCHANT OF VENICE 1989-1990,46TH STREET,5444942,0,131041,19,84,103
THE MIKADO,VIRGINIA,490302,0,23368,3,37,40
THE MINUTES,CORT,5139210,86,60646,33,87,120
THE MIRACLE WORKER,CIRCLE IN THE SQUARE,1687067,47,36610,21,38,59
THE MISER,CIRCLE,970436,0,62373,23,93,116
THE MOLIERE COMEDIES,CRITERION,1487984,0,41638,26,61,87
THE MOST HAPPY FELLA,BOOTH,4754838,0,156146,23,229,252
THE MOTHERF**KER WITH THE HAT,SCHOENFELD,10451323,81,130240,28,112,140
THE MOUNTAINTOP,JACOBS,10864181,88,123293,24,117,141
THE MUSIC MAN,NEIL SIMON,128531126,110,1051890,68,864,932
THE MUSICAL COMEDY MURDERS,LONGACRE,1091537,0,66736,6,136,142
THE MYSTERY OF CHARLES DICKENS,BELASCO,253992,33,7526,7,20,27
THE MYSTERY OF EDWIN DROOD,STUDIO 54,7191342,58,122792,28,136,164
THE NANCE,LYCEUM,8563126,77,112339,28,136,164
THE NAP,FRIEDMAN,1819944,48,38426,25,53,78
THE NEW ONE,CORT,4007178,61,65512,18,81,99
THE NIGHT OF THE IGUANA,CRITERION,1540907,36,43376,18,69,87
The Night of the Iguana 1988,CIRCLE,568644,0,38378,11,81,92
THE NORMAL HEART,GOLDEN,4237705,61,67970,10,86,96
THE NORMAN CONQUESTS,CIRCLE IN THE SQUARE,4256181,56,75224,18,109,127
THE ODD COUPLE,BROOKS ATKINSON,28938436,97,296923,28,249,277
THE ODD COUPLE 1985-1986,BROADHURST,5556919,0,215658,9,295,304
THE OLD NEIGHBORHOOD,BOOTH,3820480,34,111014,11,197,208
THE OTHER PLACE,FRIEDMAN,2876466,57,49929,34,61,95
THE PAJAMA GAME,AMERICAN AIRLINES,8885204,75,120528,41,129,170
THE PARISIAN WOMAN,HUDSON,9771836,88,110665,25,116,141
THE PEE-WEE HERMAN SHOW,STEPHEN SONDHEIM,6296959,98,64173,18,62,80
THE PEOPLE IN THE PICTURE,STUDIO 54,2469422,44,56633,30,60,90
THE PERFORMERS,LONGACRE,737219,37,19860,24,6,30
THE PETITION,Golden,883085,0,48859,10,75,85
THE PHANTOM OF THE OPERA,MAJESTIC,1286016567,55,19655343,16,13651,13667
THE PHILANTHROPIST,AMERICAN AIRLINES,2463705,49,49691,19,73,92
THE PIANO LESSON,WALTER KERR,6396570,0,259106,8,328,336
THE PILLOWMAN,BOOTH,8946186,65,137521,23,185,208
THE PIRATE QUEEN,HILTON THEATRE,9054539,61,149476,32,85,117
THE PITMEN PAINTERS,FRIEDMAN,2330017,52,44965,18,78,96
THE PLAY THAT GOES WRONG,LYCEUM,34341708,68,500844,27,737,764
THE PLAY WHAT I WROTE,LYCEUM,2530951,40,63237,27,89,116
THE PLAY'S THE THING,CRITERION,969991,0,32156,26,45,71
THE PRESENT,ETHEL BARRYMORE,10880989,124,88013,22,81,103
THE PRICE,AMERICAN AIRLINES,7546779,102,73903,31,69,100
The Price 1992,CRITERION,715800,0,29398,25,46,71
The Price 1999-2000,ROYALE,3013098,34,90661,20,128,148
THE PRINCE OF CENTRAL PARK,BELASCO,128907,0,7738,19,4,23
THE PRODUCERS,ST. JAMES,288361724,78,3672795,33,2502,2535
THE PROM,LONGACRE,25012263,84,295187,23,309,332
THE RAINMAKER,BROOKS ATKINSON,3321242,38,88453,25,82,107
THE RASCALS: ONCE UPON A DREAM,RICHARD RODGERS,2245793,122,18432,1,14,15
THE REAL INSPECTOR HOUND,CRITERION,855076,0,32296,17,61,78
THE REAL THING,ETHEL BARRYMORE,19754682,26,481689,56,604,660
THE REALISTIC JONESES,LYCEUM,8209761,86,95429,27,105,132
THE RED SHOES,GERSHWIN,2568652,0,66477,51,5,56
THE REGARD OF FLIGHT,VIVIAN BEAUMONT,232287,0,13127,7,17,24
THE REHEARSAL,CRITERION,1147712,32,36206,25,55,80
THE RETREAT FROM MOSCOW,BOOTH,4496405,50,89666,24,147,171
THE RIDE DOWN MT. MORGAN,AMBASSADOR,3948515,40,99678,23,121,144
THE RISE AND FALL OF LITTLE VOICE,NEIL SIMON,193203,0,17936,19,9,28
THE RITZ,STUDIO 54,3438536,46,75147,30,69,99
THE RIVALS,VIVIAN BEAUMONT,2275152,49,46130,23,45,68
THE RIVER,CIRCLE IN THE SQUARE,10827016,135,80722,18,97,115
THE ROAD TO MECCA,AMERICAN AIRLINES,2082656,48,42360,34,56,90
THE ROCKY HORROR SHOW,CIRCLE,13431400,50,268017,30,437,467
THE ROSE TATTOO,CIRCLE,6442169,46,101305,37,136,173
THE ROYAL FAMILY,FRIEDMAN,2627586,49,53252,26,77,103
THE SCARLET PIMPERNEL,NEIL SIMON,40692704,44,924543,39,772,811
THE SCOTTSBORO BOYS,LYCEUM,2750411,52,52266,29,49,78
THE SEAFARER,BOOTH,4512348,57,76919,19,133,152
THE SEAGULL,WALTER KERR,6430741,75,85825,18,94,112
THE SEAGULL 1992-1993,LYCEUM,790509,0,33938,15,49,64
THE SEARCH FOR SIGNS OF INTELLIGENT LIFE IN THE UNIVERSE,BOOTH,5562894,48,114278,6,184,190
THE SECRET GARDEN,ST. JAMES,31609844,0,815536,23,709,732
THE SECRET RAPTURE,ETHEL BARRYMORE,256723,0,14288,19,12,31
THE SHOW-OFF,CRITERION,636120,0,25160,26,45,71
THE SISTERS ROSENSWEIG,ETHEL BARRYMORE,19086077,0,510634,18,556,574
THE SKIN OF OUR TEETH,VIVIAN BEAUMONT,1417678,45,32059,26,35,61
THE SMELL OF THE KILL,HELEN HAYES,533380,30,17858,20,40,60
THE SNOW GEESE,FRIEDMAN,2376183,54,44083,25,60,85
THE SONG OF JACOB ZULU,PLYMOUTH,1281899,0,45768,9,53,62
THE SOUND INSIDE,STUDIO 54,8329312,86,96171,37,100,137
THE SOUND OF MUSIC,MARTIN BECK,34483971,54,642006,38,533,571
THE SPEED OF DARKNESS,LYCEUM,375965,0,24474,16,36,52
THE STORY OF MY LIFE,BOOTH,264611,40,6628,19,5,24
THE SUNSHINE BOYS,LYCEUM,5023827,39,127504,12,230,242
THE TALE OF THE ALLERGIST'S WIFE,ETHEL BARRYMORE,29310727,48,612691,25,777,802
THE TAP DANCE KID,MINSKOFF,14946615,0,595928,0,496,496
THE TEMPEST,BROADHURST,4609277,22,91218,25,70,95
THE TEMPTATIONS AND THE FOUR TOPS ON BROADWAY,PALACE,819461,93,8780,0,7,7
THE TENTH MAN,VIVIAN BEAUMONT,714838,0,47284,35,41,76
THE TERMS OF MY SURRENDER,BELASCO,4209550,59,74484,13,83,96
THE TESTAMENT OF MARY,WALTER KERR,1279803,40,32424,27,16,43
THE THREEPENNY OPERA,STUDIO 54,5806155,59,98279,32,77,109
THE TIMES THEY ARE A-CHANGIN',BROOKS ATKINSON,2636161,53,50023,35,28,63
THE TRIP TO BOUNTIFUL,STEPHEN SONDHEIM,13498945,86,158164,27,187,214
THE VELOCITY OF AUTUMN,BOOTH,544617,29,19293,22,16,38
THE VERTICAL HOUR,MUSIC BOX,7308875,69,104375,23,117,140
THE VIOLET HOUR,BILTMORE,2037981,52,39431,23,54,77
THE VISIT,CRITERION,3201020,26,85742,58,106,164
THE WAVERLY GALLERY,GOLDEN,7668657,77,99041,32,109,141
THE WEDDING SINGER,AL HIRSCHFELD,19995744,66,301613,28,285,313
THE WEIR,WALTER KERR,6874875,38,179837,10,277,287
THE WILD PARTY,VIRGINIA,3919522,50,79170,36,68,104
THE WINSLOW BOY,AMERICAN AIRLINES,2392300,55,42745,32,53,85
THE WOMAN IN WHITE,MARQUIS,10445368,68,152490,20,109,129
THE WOMEN,AMERICAN AIRLINES,4183178,54,77827,32,77,109
THE WORLD ACCORDING TO ME,BROOKS ATKINSON,12989003,0,547826,7,576,583
THE YEAR OF MAGICAL THINKING,BOOTH,7293267,70,100961,23,144,167
THE YOUNG MAN FROM ATLANTA,LONGACRE,1340187,27,50356,17,84,101
THÃ‰RÃˆSE RAQUIN,STUDIO 54,5184011,73,71091,30,75,105
THIS IS OUR YOUTH,CORT,7229324,65,112415,26,133,159
THOROUGHLY MODERN MILLIE,MARQUIS,75616509,63,1193581,32,903,935
THOSE WERE THE DAYS,EDISON,1106101,0,51567,18,126,144
THOU SHALT NOT,PLYMOUTH,3894953,46,85740,33,85,118
THOUGHTS OF A COLORED MAN,GOLDEN,3839605,77,49442,12,77,89
THREE DAYS OF RAIN,JACOBS,11427896,111,102670,26,70,96
THREE FROM BROOKLYN,HELEN HAYES,214081,0,10061,8,45,53
THREE MEN ON A HORSE,LYCEUM,1031113,0,41277,24,39,63
THREE MUSKETEERS,BROADWAY,407838,0,19845,15,9,24
THREE PENNY OPERA,LUNT-FONTANNE,4721700,0,103647,20,65,85
THREE SISTERS,CRITERION,1708904,39,43322,26,61,87
THREE TALL WOMEN,GOLDEN,13906153,133,102982,30,102,132
THURGOOD,BOOTH,4613166,58,80291,19,126,145
TIME AND THE CONWAYS,AMERICAN AIRLINES,3148688,63,49620,27,56,83
TIME STANDS STILL,FRIEDMAN,10428041,68,154459,44,193,237
TIMON OF ATHENS,LYCEUM,510164,0,20605,16,39,55
TINA - THE TINA TURNER MUSICAL,LUNT-FONTANNE,66650041,131,503118,27,431,458
TITANIC,LUNT-FONTANNE,57150546,53,1065828,26,804,830
TITLE OF SHOW,LYCEUM,2188129,46,47894,13,102,115
TO BE OR NOT TO BE,FRIEDMAN,1166048,53,21960,32,40,72
TO KILL A MOCKINGBIRD,SHUBERT,137973402,144,948725,45,623,668
TOMMY,ST. JAMES,54390759,0,1148704,27,899,926
TOMMY TUNE TONITE,GERSHWIN,744319,0,17511,4,10,14
TOOTSIE,MARQUIS,38439038,97,396058,25,293,318
TOP GIRLS,BILTMORE,2211556,54,41199,25,62,87
TOPDOG / UNDERDOG,AMBASSADOR,5405007,43,121725,31,144,175
TORCH SONG,HAYES,3140498,66,47853,26,77,103
TORCH SONG TRILOGY,HELEN HAYES,1255000,0,100000,0,400,400
TRANSLATIONS,BILTMORE,2141231,49,43049,24,53,77
TRANSLATIONS 1995,PLYMOUTH,935190,0,27707,15,25,40
TRAVESTIES,AMERICAN AIRLINES,4355637,79,54305,27,63,90
TRIUMPH OF LOVE,ROYALE,3700422,46,80669,30,85,115
TROUBLE IN MIND,AMERICAN AIRLINES,1713773,45,37041,20,58,78
TRU,BOOTH,3621706,0,159968,11,297,308
TRUE WEST,CIRCLE,10922725,64,158562,51,215,266
TRULY BLESSED,LONGACRE,324829,0,16920,12,33,45
TUCK EVERLASTING,BROADHURST,2943941,51,59117,28,39,67
TWELFTH NIGHT,VIVIAN BEAUMONT,3602900,42,84557,30,53,83
TWELFTH NIGHT/RICHARD III,BELASCO,13930965,94,147748,28,113,141
TWELVE ANGRY MEN,AMERICAN AIRLINES,9325569,56,164852,32,228,260
TWENTIETH CENTURY,AMERICAN AIRLINES,3869161,54,72398,27,84,111
TWILIGHT OF THE GOLDS,BOOTH,496355,0,22655,15,29,44
TWILIGHT: LOS ANGELES,CORT,1106723,0,41770,7,72,79
TWO SHAKESPEAREAN ACTORS,CORT,676876,0,48118,33,29,62
TWO TRAINS RUNNING,WALTER KERR,3043768,0,132923,7,160,167
UNCLE VANYA,BROOKS ATKINSON,2366742,37,64242,29,49,78
Uncle Vanya 1995,CIRCLE,421847,0,17968,23,29,52
UPTOWN...IT'S HOT,LUNT-FONTANNE,489307,0,21329,13,24,37
URBAN COWBOY,BROADHURST,1288667,54,23533,26,60,86
URINETOWN,HENRY MILLER,34815864,66,524188,25,965,990
VANYA AND SONIA AND MASHA AND SPIKE,GOLDEN,13130430,94,138147,11,189,200
VENUS IN FUR,FRIEDMAN,9550145,76,124848,37,191,228
VIA DOLOROSA,BOOTH,1751272,31,55886,15,99,114
VICTOR/VICTORIA,MARQUIS,58754023,53,995827,25,734,759
VINCENT IN BRIXTON,Golden,1915989,38,50193,23,69,92
VIOLET,AMERICAN AIRLINES,6616618,70,94762,27,128,155
VOICES IN THE DARK,LONGACRE,1245034,30,42090,12,68,80
WAIT UNTIL DARK,BROOKS ATKINSON,4125132,45,91598,11,97,108
WAITING FOR GODOT,STUDIO 54,6908255,62,111164,32,84,116
WAITING IN THE WINGS,WALTER KERR,3146238,60,52581,16,69,85
WAITRESS,BROOKS ATKINSON,184781903,116,1580963,33,1666,1699
WAR HORSE,VIVIAN BEAUMONT,74975253,102,726281,33,718,751
WAR PAINT,NEDERLANDER,24811139,93,264985,33,236,269
WELCOME TO THE CLUB,MUSIC BOX,139596,0,7113,20,12,32
WELL,LONGACRE,1162288,42,27536,23,52,75
WEST SIDE STORY,BROADWAY,19788753,116,170520,77,21,98
West Side Story 2009-2011,PALACE,93028454,85,1074462,27,748,775
WHAT THE CONSTITUTION MEANS TO ME,HAYES,11325732,107,105418,19,164,183
WHAT'S WRONG WITH THIS PICTURE,BROOKS ATKINSON,608942,0,32528,27,12,39
WHO'S AFRAID OF VIRGINIA WOOLF?,LONGACRE,12116848,69,179970,31,276,307
WHOOPI,LYCEUM,2584289,51,50144,12,72,84
WHOOPI GOLDBERG,LYCEUM,1973901,0,87564,18,156,174
WICKED,GERSHWIN,1438996792,112,12753338,25,7159,7184
WILD HONEY,VIRGINIA,603624,0,25153,8,28,36
WILDER WILDER WILDER,CIRCLE,301716,0,17161,14,30,44
WILL ROGERS' FOLLIES,PALACE,54685976,0,1155341,33,981,1014
WIND IN THE WILLOWS,NEDERLANDER,196902,0,10740,25,4,29
WISHFUL DRINKING,STUDIO 54,5649906,56,102216,15,118,133
WIT,FRIEDMAN,2302405,52,44863,24,60,84
WOLF HALL PARTS ONE & TWO,WINTER GARDEN,9970896,96,104415,21,103,124
WOMEN ON THE VERGE OF A NERVOUS BREAKDOWN,BELASCO,4820272,66,73822,30,69,99
WONDERFUL TENNESSEE,PLYMOUTH,572731,0,22792,20,9,29
WONDERFUL TOWN,AL HIRSCHFELD,29830255,66,449677,16,497,513
WONDERHOUSE,BROADHURST,96031,0,5339,11,9,20
WONDERLAND,MARQUIS,4438971,52,84646,30,33,63
XANADU,HELEN HAYES,17126310,70,240985,49,512,561
YANNI,LUNT-FONTANNE,527138,107,4925,0,5,5
YOU CAN'T TAKE IT WITH YOU,LONGACRE,13227324,83,160368,39,169,208
YOU NEVER CAN TELL,CIRCLE,1153718,0,61296,23,125,148
YOU'RE A GOOD MAN CHARLIE BROWN,AMBASSADOR,3630774,43,84237,14,149,163
YOU'RE WELCOME AMERICA. A FINAL NIGHT WITH GEORGE W. BUSH,CORT,6723050,101,66710,18,46,64
ZORBA,BROADWAY,2470523,0,88377,0,80,80
ZOYA'S APARTMENT,CIRCLE,363761,0,22745,13,45,58
